Pays,Ann√©e,Female_Population,Male_Population,Rural_Population,Urban_Population,Total_Population
Afghanistan,2000,10090449,10689508,15657474,4436282,20779957
Afghanistan,2001,10489238,11117754,16318324,4648139,21606992
Afghanistan,2002,10958668,11642106,17086910,4893013,22600774
Afghanistan,2003,11466237,12214634,17909063,5155788,23680871
Afghanistan,2004,11962963,12763726,18692107,5426872,24726689
Afghanistan,2005,12414590,13239684,19378962,5691836,25654274
Afghanistan,2006,12809162,13623896,19961972,5931478,26433058
Afghanistan,2007,13161572,13938970,20464923,6151869,27100542
Afghanistan,2008,13496556,14225725,20929119,6364912,27722281
Afghanistan,2009,13850751,14544055,21415593,6588738,28394806
Afghanistan,2010,14249755,14935756,21966187,6836980,29185511
Afghanistan,2011,14702050,15415361,22594126,7114473,30117411
Afghanistan,2012,15196504,15964874,23280663,7416295,31161378
Afghanistan,2013,15715314,16554277,23997856,7733832,32269591
Afghanistan,2014,16232001,17138803,24703798,8054222,33370804
Afghanistan,2015,16727437,17686166,25368923,8367571,34413603
Afghanistan,2016,17196034,18186994,25985093,8670939,35383028
Afghanistan,2017,17644126,18651985,26558609,8971472,36296111
Afghanistan,2018,18078879,19093043,27099874,9273302,37171922
Albania,2000,1545740,1583506,1818833,1303137,3129246
Albania,2001,1543523,1586178,1797423,1324985,3129701
Albania,2002,1543247,1582936,1762229,1356800,3126183
Albania,2003,1543176,1574841,1724344,1386661,3118017
Albania,2004,1540927,1563966,1683584,1414163,3104893
Albania,2005,1534835,1551975,1640246,1438933,3086810
Albania,2006,1524300,1538721,1593892,1460439,3063021
Albania,2007,1510100,1523893,1545166,1478741,3033993
Albania,2008,1493764,1508919,1496108,1495543,3002683
Albania,2009,1477486,1495558,1449427,1513208,2973044
Albania,2010,1462961,1485068,1406665,1533860,2948029
Albania,2011,1450542,1478059,1368297,1558362,2928601
Albania,2012,1439880,1474211,1333585,1586454,2914091
Albania,2013,1431118,1472670,1302236,1616742,2903788
Albania,2014,1424212,1472095,1272790,1647985,2896307
Albania,2015,1419068,1471456,1244341,1679011,2890524
Albania,2016,1415879,1470548,1216737,1709611,2886427
Albania,2017,1414581,1469588,1190155,1740032,2884169
Albania,2018,1414359,1468376,1164388,1769975,2882735
Algeria,2000,15311139,15731099,12498847,18684813,31042238
Algeria,2001,15516424,15935089,12411940,19180213,31451513
Algeria,2002,15721105,16134005,12317847,19677199,31855110
Algeria,2003,15930173,16333986,12221443,20182071,32264159
Algeria,2004,16149500,16542652,12127441,20703655,32692152
Algeria,2005,16383693,16766026,12040491,21247946,33149719
Algeria,2006,16634748,17006259,11959903,21818012,33641007
Algeria,2007,16903082,17263894,11885693,22414383,34166976
Algeria,2008,17189426,17541178,11818949,23041766,34730604
Algeria,2009,17493858,17840024,11765339,23700421,35333882
Algeria,2010,17816091,18161360,11723941,24393696,35977451
Algeria,2011,18155827,18505611,11695477,25124081,36661438
Algeria,2012,18512336,18871563,11677502,25888345,37383899
Algeria,2013,18884019,19256116,11664030,26674532,38140135
Algeria,2014,19268759,19654929,11647651,27465662,38923688
Algeria,2015,19664129,20063891,11623281,28248247,39728020
Algeria,2016,20069497,20481901,11589537,29016515,40551398
Algeria,2017,20482418,20906756,11547532,29770610,41389174
Algeria,2018,20896422,21331993,11498038,30510016,42228415
Angola,2000,8240458,8155019,8206100,8234824,16395477
Angola,2001,8521795,8423958,8275248,8708018,16945753
Angola,2002,8814755,8704663,8353851,9218798,17519418
Angola,2003,9122235,8999242,8438128,9765241,18121477
Angola,2004,9447886,9310252,8522221,10343495,18758138
Angola,2005,9794134,9639470,8603118,10949424,19433604
Angola,2006,10162225,9987680,8760700,11501699,20149905
Angola,2007,10551020,10354340,8918911,12078776,20905360
Angola,2008,10957506,10738130,9077515,12681905,21695636
Angola,2009,11377265,11137010,9237545,13312002,22514275
Angola,2010,11806970,11549277,9398277,13970854,23356247
Angola,2011,12245836,11974824,9559614,14658951,24220660
Angola,2012,12694373,12413552,9720169,15375981,25107925
Angola,2013,13151985,12863801,9878943,16119397,26015786
Angola,2014,13618285,13323488,10033109,16887357,26941773
Angola,2015,14093136,13791244,10183560,17675745,27884380
Angola,2016,14576127,14266355,10329860,18483603,28842482
Angola,2017,15067450,14749319,10472554,19311639,29816769
Angola,2018,15568328,15241459,10612667,20161538,30809787
Antigua and Barbuda,2000,40297,35710,56731,26853,76007
Antigua and Barbuda,2001,40924,36288,58060,26997,77212
Antigua and Barbuda,2002,41444,36854,59439,26827,78298
Antigua and Barbuda,2003,41886,37425,60700,26593,79311
Antigua and Barbuda,2004,42338,38009,61924,26333,80347
Antigua and Barbuda,2005,42832,38630,63175,26078,81462
Antigua and Barbuda,2006,43401,39314,64468,25832,82715
Antigua and Barbuda,2007,44012,40017,65792,25589,84029
Antigua and Barbuda,2008,44663,40731,67134,25344,85394
Antigua and Barbuda,2009,45299,41444,68485,25096,86743
Antigua and Barbuda,2010,45912,42118,69824,24837,88030
Antigua and Barbuda,2011,46487,42763,71116,24603,89250
Antigua and Barbuda,2012,47034,43373,72074,24703,90407
Antigua and Barbuda,2013,47559,43951,73026,24798,91510
Antigua and Barbuda,2014,48060,44502,73984,24891,92562
Antigua and Barbuda,2015,48543,45028,74942,24981,93571
Antigua and Barbuda,2016,49002,45518,75878,25085,94520
Antigua and Barbuda,2017,49439,45986,76802,25210,95425
Antigua and Barbuda,2018,49863,46419,77700,25350,96282
Argentina,2000,18976071,17894725,4023693,33033759,36870796
Argentina,2001,19185008,18090636,3998739,33472769,37275644
Argentina,2002,19390957,18290786,3974741,33914629,37681743
Argentina,2003,19594321,18493545,3951197,34358182,38087866
Argentina,2004,19795649,18696321,3927028,34801668,38491970
Argentina,2005,19995559,18897365,3902354,35243134,38892924
Argentina,2006,20193900,19095976,3876846,35682044,39289876
Argentina,2007,20391134,19293169,3850764,36119460,39684303
Argentina,2008,20589210,19490949,3824321,36558068,40080159
Argentina,2009,20790604,19692182,3798178,37001229,40482786
Argentina,2010,20997000,19898751,3772300,37451589,40895751
Argentina,2011,21209171,20111326,3753490,37903389,41320497
Argentina,2012,21426344,20328844,3737979,38358760,41755188
Argentina,2013,21646646,20549388,3722489,38817436,42196034
Argentina,2014,21867322,20770186,3706372,39275143,42637508
Argentina,2015,22086266,20989150,3689407,39728358,43075416
Argentina,2016,22302860,21205599,3671449,40175981,43508459
Argentina,2017,22517342,21419801,3652804,40618237,43937143
Argentina,2018,22729477,21631673,3632997,41055867,44361150
Armenia,2000,1628677,1440920,1084598,1984990,3069597
Armenia,2001,1618693,1431993,1086476,1964179,3050686
Armenia,2002,1609123,1424853,1085046,1948851,3033976
Armenia,2003,1599617,1418321,1082281,1935525,3017938
Armenia,2004,1589758,1410957,1079095,1921517,3000715
Armenia,2005,1579392,1401870,1075092,1906167,2981262
Armenia,2006,1568085,1390216,1069827,1888673,2958301
Armenia,2007,1556118,1376497,1063546,1869510,2932615
Armenia,2008,1544816,1362799,1057443,1850777,2907615
Armenia,2009,1536021,1352073,1053182,1835402,2888094
Armenia,2010,1530963,1346351,1051946,1825365,2877314
Armenia,2011,1530148,1346388,1054190,1821391,2876536
Armenia,2012,1532984,1351255,1059405,1822517,2884239
Armenia,2013,1538334,1359259,1065858,1827651,2897593
Armenia,2014,1544503,1367900,1072043,1834177,2912403
Armenia,2015,1550226,1375333,1076799,1840151,2925559
Armenia,2016,1555133,1381014,1079792,1845024,2936147
Armenia,2017,1559427,1385362,1081248,1849202,2944789
Armenia,2018,1563141,1388600,1081275,1852877,2951741
Australia,2000,9517890,9473544,3005744,16060093,18991434
Australia,2001,9617648,9577028,3063632,16204901,19194676
Australia,2002,9721034,9680332,3072827,16402364,19401366
Australia,2003,9833263,9790900,3084036,16612936,19624163
Australia,2004,9960987,9918667,3099437,16848992,19879654
Australia,2005,10108474,10070069,3120469,17118434,20178543
Australia,2006,10277859,10248441,3147693,17425913,20526300
Australia,2007,10466557,10449782,3179302,17767362,20916339
Australia,2008,10668128,10664165,3213567,18128926,21332293
Australia,2009,10873379,10877473,3247226,18491814,21750852
Australia,2010,11075315,11079372,3277772,18842292,22154687
Australia,2011,11271768,11266234,3304468,19175331,22538002
Australia,2012,11463500,11440451,3331639,19490210,22903951
Australia,2013,11649885,11605027,3356405,19794324,23254912
Australia,2014,11831057,11765369,3379903,20094765,23596426
Australia,2015,12007144,11925355,3403025,20396531,23932499
Australia,2016,12177326,12085384,3425805,20700043,24262710
Australia,2017,12340977,12243642,3446638,21003923,24584619
Australia,2018,12498779,12399374,3465207,21307040,24898153
Austria,2000,4152872,3916404,3210563,4858713,8069276
Austria,2001,4165466,3932288,3244424,4853324,8097754
Austria,2002,4183002,3951400,3281833,4852579,8134402
Austria,2003,4203463,3972392,3321438,4854414,8175855
Austria,2004,4223711,3993099,3361157,4855648,8216810
Austria,2005,4241597,4012059,3399400,4854250,8253656
Austria,2006,4256445,4028900,3435541,4849194,8285345
Austria,2007,4269230,4044501,3470218,4841565,8313731
Austria,2008,4281346,4060179,3504967,4833486,8341525
Austria,2009,4294879,4077779,3541925,4828113,8372658
Austria,2010,4311303,4098642,3582684,4827265,8409945
Austria,2011,4330724,4122777,3628001,4831863,8453501
Austria,2012,4352537,4149693,3650043,4867505,8502230
Austria,2013,4376590,4179600,3659591,4918191,8556190
Austria,2014,4402555,4212650,3666869,4966351,8615205
Austria,2015,4430011,4248656,3669727,5008930,8678667
Austria,2016,4459210,4288096,3667377,5044760,8747306
Austria,2017,4489710,4330192,3660707,5074746,8819902
Austria,2018,4519439,4371944,3649748,5102072,8891383
Azerbaijan,2000,4151287,3971455,3948767,4173974,8122742
Azerbaijan,2001,4184661,4012634,3968573,4228706,8197295
Azerbaijan,2002,4219230,4057835,3990569,4286446,8277065
Azerbaijan,2003,4255236,4106197,4014461,4346898,8361433
Azerbaijan,2004,4292732,4156206,4039517,4409365,8448938
Azerbaijan,2005,4331801,4206809,4065323,4473283,8538610
Azerbaijan,2006,4372492,4257661,4091637,4538558,8630153
Azerbaijan,2007,4415022,4309215,4118779,4605524,8724237
Azerbaijan,2008,4459776,4362093,4147173,4674735,8821869
Azerbaijan,2009,4507172,4417211,4177524,4746883,8924383
Azerbaijan,2010,4557375,4475090,4208623,4823834,9032465
Azerbaijan,2011,4610498,4535779,4240564,4905815,9146277
Azerbaijan,2012,4666054,4598630,4272681,4992236,9264684
Azerbaijan,2013,4722860,4662607,4303619,5081674,9385467
Azerbaijan,2014,4779331,4726285,4331615,5172156,9505616
Azerbaijan,2015,4834228,4788513,4355344,5262140,9622741
Azerbaijan,2016,4887110,4848931,4374332,5351044,9736041
Azerbaijan,2017,4937926,4907390,4388663,5438926,9845316
Azerbaijan,2018,4986285,4963252,4398268,5525646,9949537
Bahamas,2000,152870,145175,53599,244291,298045
Bahamas,2001,155430,147188,54415,248720,302618
Bahamas,2002,158124,149533,55365,253792,307657
Bahamas,2003,160976,152147,56412,259334,313123
Bahamas,2004,163970,154923,57487,265039,318893
Bahamas,2005,167075,157773,58548,270701,324848
Bahamas,2006,170333,160699,59577,276253,331032
Bahamas,2007,173698,163689,60587,281741,337387
Bahamas,2008,177029,166651,61564,287112,343680
Bahamas,2009,180150,169450,62508,292348,349600
Bahamas,2010,182929,172007,63410,297422,354936
Bahamas,2011,185312,174271,64238,302330,359583
Bahamas,2012,187327,176254,64986,307053,363581
Bahamas,2013,189106,178056,65653,311587,367162
Bahamas,2014,190815,179810,66238,315931,370625
Bahamas,2015,192592,181608,66744,320094,374200
Bahamas,2016,194446,183477,67166,324066,377923
Bahamas,2017,196365,185384,67508,327853,381749
Bahamas,2018,198313,187322,67779,331506,385635
Bahrain,2000,283385,381225,77278,587336,664610
Bahrain,2001,294861,402689,81130,616419,697550
Bahrain,2002,307145,427995,85478,649670,735140
Bahrain,2003,320830,457878,90466,688245,778708
Bahrain,2004,336655,493191,96270,733578,829846
Bahrain,2005,355017,534140,102947,786221,889157
Bahrain,2006,376356,582067,110681,847733,958423
Bahrain,2007,400131,635793,119256,916635,1035924
Bahrain,2008,424602,690043,127843,986747,1114645
Bahrain,2009,447377,737698,135345,1049684,1185075
Bahrain,2010,466813,774051,141040,1099822,1240864
Bahrain,2011,482116,796037,144510,1133759,1278153
Bahrain,2012,493912,806030,146117,1154100,1299942
Bahrain,2013,503660,811369,146861,1168550,1315029
Bahrain,2014,513533,822540,148146,1188251,1336073
Bahrain,2015,525097,846756,150912,1220943,1371853
Bahrain,2016,538855,886938,155487,1269684,1425793
Bahrain,2017,554227,939850,161409,1331175,1494077
Bahrain,2018,570464,998976,167867,1399126,1569440
Bangladesh,2000,62062864,65594998,100540592,31040651,127657862
Bangladesh,2001,63271242,66817467,101793097,32314063,130088709
Bangladesh,2002,64460652,68017425,102783564,33817103,132478077
Bangladesh,2003,65621300,69170298,103668291,35350710,134791598
Bangladesh,2004,66741554,70244874,104406336,36901153,136986428
Bangladesh,2005,67813911,71221594,104978125,38452976,139035505
Bangladesh,2006,68833643,72087511,105366709,40001295,140921154
Bangladesh,2007,69804543,72855838,105592037,41547154,142660381
Bangladesh,2008,70738452,73565712,105699286,43106528,144304164
Bangladesh,2009,71652503,74272292,105756065,44698643,145924795
Bangladesh,2010,72559741,75015692,105802013,46347089,147575433
Bangladesh,2011,73463440,75809694,105853212,48058704,149273134
Bangladesh,2012,74361840,76643893,105905797,49821256,151005733
Bangladesh,2013,75256812,77504601,105947078,51624214,152761413
Bangladesh,2014,76149165,78368220,105949491,53455788,154517385
Bangladesh,2015,77039130,79217157,105895754,55305132,156256287
Bangladesh,2016,77928241,80048910,105783530,57168030,157977151
Bangladesh,2017,78816353,80869068,105622933,59046818,159685421
Bangladesh,2018,79699596,81677117,105423904,60944245,161376713
Barbados,2000,141059,130452,178566,91281,271511
Barbados,2001,141594,130900,179657,91028,272494
Barbados,2002,142102,131321,180720,90758,273423
Barbados,2003,142595,131736,181776,90482,274331
Barbados,2004,143113,132170,182870,90221,275283
Barbados,2005,143674,132646,184021,89988,276320
Barbados,2006,144306,133169,185251,89788,277475
Barbados,2007,144981,133720,186537,89613,278701
Barbados,2008,145651,134295,187866,89453,279946
Barbados,2009,146253,134854,189184,89286,281107
Barbados,2010,146745,135386,190470,89099,282131
Barbados,2011,147110,135877,191650,88951,282987
Barbados,2012,147358,136340,192736,88849,283698
Barbados,2013,147525,136769,193719,88790,284294
Barbados,2014,147656,137169,194607,88778,284825
Barbados,2015,147779,137548,195402,88815,285327
Barbados,2016,147896,137902,196098,88898,285798
Barbados,2017,148006,138223,196693,89026,286229
Barbados,2018,148115,138525,197187,89201,286640
Belarus,2000,5237587,4634048,2982752,6950857,9871635
Belarus,2001,5208507,4602892,2916670,6956291,9811399
Belarus,2002,5178382,4567550,2850055,6957077,9745932
Belarus,2003,5148737,4530498,2784170,6955884,9679235
Belarus,2004,5121497,4495131,2720421,6956481,9616628
Belarus,2005,5098097,4463986,2660005,6961538,9562083
Belarus,2006,5079069,4437815,2602913,6972130,9516884
Belarus,2007,5064248,4416266,2548939,6987925,9480514
Belarus,2008,5053329,4399526,2497993,7009338,9452855
Belarus,2009,5045719,4387440,2450081,7036158,9433159
Belarus,2010,5040845,4379731,2399353,7073718,9420576
Belarus,2011,5038635,4376681,2349339,7119161,9415316
Belarus,2012,5038976,4378069,2301873,7169857,9417045
Belarus,2013,5041104,4382398,2256120,7222782,9423502
Belarus,2014,5044051,4387691,2210624,7274227,9431742
Belarus,2015,5047013,4392411,2164605,7321167,9439424
Belarus,2016,5049689,4395949,2117714,7362328,9445638
Belarus,2017,5051866,4398367,2070382,7397955,9450233
Belarus,2018,5052995,4399620,2023242,7428871,9452615
Belgium,2000,5247226,5034820,295224,9986809,10282046
Belgium,2001,5264570,5054456,290416,10028603,10319026
Belgium,2002,5286007,5078872,285916,10078969,10364879
Belgium,2003,5311430,5107599,281701,10137331,10419029
Belgium,2004,5340455,5139663,277714,10202403,10480118
Belgium,2005,5372650,5174235,273934,10272952,10546885
Belgium,2006,5408058,5211426,270335,10349232,10619484
Belgium,2007,5446412,5251164,266907,10430928,10697576
Belgium,2008,5486586,5292178,263573,10515600,10778764
Belgium,2009,5527104,5332830,260273,10600017,10859934
Belgium,2010,5566774,5371961,256927,10681812,10938735
Belgium,2011,5605193,5408667,253515,10759568,11013860
Belgium,2012,5642207,5443148,250039,10833511,11085355
Belgium,2013,5677241,5476767,246557,10904955,11154008
Belgium,2014,5709727,5511498,243099,10976062,11221225
Belgium,2015,5739297,5548634,239703,11048237,11287931
Belgium,2016,5765616,5588791,236371,11122008,11354407
Belgium,2017,5788746,5631006,233097,11196239,11419752
Belgium,2018,5809216,5672964,229844,11268675,11482180
Belize,2000,122794,124516,135040,112275,247310
Belize,2001,126663,128405,139270,115714,255068
Belize,2002,130322,132065,143260,118946,262387
Belize,2003,133849,135579,147088,122042,269428
Belize,2004,137430,139086,150939,125150,276516
Belize,2005,141136,142662,154917,128360,283798
Belize,2006,145011,146327,159051,131696,291338
Belize,2007,148995,150036,163292,135115,299031
Belize,2008,153039,153783,167590,138575,306822
Belize,2009,157107,157548,171893,142036,314655
Belize,2010,161137,161328,176152,145456,322465
Belize,2011,165121,165115,180304,148888,330236
Belize,2012,169084,168917,184356,152345,338001
Belize,2013,173008,172699,188329,155852,345707
Belize,2014,176919,176447,192252,159442,353366
Belize,2015,180791,180135,196149,163139,360926
Belize,2016,184647,183752,200009,166945,368399
Belize,2017,188479,187296,203824,170857,375775
Belize,2018,192273,190798,207573,174871,383071
Benin,2000,3483088,3382858,4234053,2631898,6865946
Benin,2001,3585778,3490950,4341571,2735162,7076728
Benin,2002,3691953,3603447,4447579,2847815,7295400
Benin,2003,3801242,3719314,4547230,2973325,7520556
Benin,2004,3913010,3836993,4646975,3103029,7750003
Benin,2005,4026821,3955402,4746002,3236223,7982223
Benin,2006,4142660,4074233,4843912,3372984,8216893
Benin,2007,4260764,4194026,4941169,3513622,8454790
Benin,2008,4381293,4315622,5038238,3658678,8696915
Benin,2009,4504448,4440265,5136061,3808645,8944713
Benin,2010,4630420,4568834,5234987,3964272,9199254
Benin,2011,4759222,4701607,5335100,4125702,9460829
Benin,2012,4890899,4838355,5436123,4293037,9729254
Benin,2013,5025698,4978896,5538224,4466227,10004594
Benin,2014,5163932,5122907,5640645,4646067,10286839
Benin,2015,5305830,5270132,5743319,4832633,10575962
Benin,2016,5451503,5420569,5846177,5026121,10872072
Benin,2017,5600895,5574297,5949046,5226646,11175192
Benin,2018,5753796,5731239,6051546,5434128,11485035
Bhutan,2000,288731,302283,427663,145753,591014
Bhutan,2001,293644,309999,433476,156124,603643
Bhutan,2002,297894,318131,439213,167186,616025
Bhutan,2003,301621,326219,444581,178853,627840
Bhutan,2004,305108,333701,449256,191026,638809
Bhutan,2005,308582,340162,453310,203329,648744
Bhutan,2006,312011,345393,459050,213178,657404
Bhutan,2007,315351,349522,463910,223048,664873
Bhutan,2008,318644,352967,467983,232967,671611
Bhutan,2009,321991,356338,471472,242986,678329
Bhutan,2010,325419,360083,474470,253171,685502
Bhutan,2011,328979,364318,476998,263512,693297
Bhutan,2012,332656,368926,479102,273865,701582
Bhutan,2013,336413,373822,480787,284174,710235
Bhutan,2014,340164,378889,482036,294412,719053
Bhutan,2015,343867,384018,482844,304542,727885
Bhutan,2016,347496,389210,483225,314540,736706
Bhutan,2017,351064,394499,483217,324393,745563
Bhutan,2018,354586,399810,482916,334138,754396
Bolivia (Plurinational State of),2000,4183450,4234820,3186751,5152761,8418270
Bolivia (Plurinational State of),2001,4263569,4316675,3202596,5293779,8580244
Bolivia (Plurinational State of),2002,4343643,4399179,3220542,5432803,8742822
Bolivia (Plurinational State of),2003,4423766,4482054,3238033,5572387,8905820
Bolivia (Plurinational State of),2004,4504108,4564936,3254315,5713426,9069044
Bolivia (Plurinational State of),2005,4584778,4647523,3269610,5855799,9232301
Bolivia (Plurinational State of),2006,4665756,4729693,3283729,5999605,9395449
Bolivia (Plurinational State of),2007,4746982,4811456,3296720,6144724,9558438
Bolivia (Plurinational State of),2008,4828485,4892972,3308578,6291277,9721457
Bolivia (Plurinational State of),2009,4910315,4974475,3319560,6439188,9884790
Bolivia (Plurinational State of),2010,4992487,5056110,3329540,6588702,10048597
Bolivia (Plurinational State of),2011,5075025,5137926,3338591,6739752,10212951
Bolivia (Plurinational State of),2012,5157863,5219814,3346648,6892356,10377677
Bolivia (Plurinational State of),2013,5240835,5301540,3359417,7040847,10542375
Bolivia (Plurinational State of),2014,5323698,5382819,3374918,7187241,10706517
Bolivia (Plurinational State of),2015,5406288,5463444,3389712,7334993,10869732
Bolivia (Plurinational State of),2016,5488505,5543317,3403747,7484135,11031822
Bolivia (Plurinational State of),2017,5570366,5622487,3417155,7634445,11192853
Bolivia (Plurinational State of),2018,5651979,5701161,3429186,7786488,11353140
Bosnia and Herzegovina,2000,1909565,1841611,2170238,1596468,3751176
Bosnia and Herzegovina,2001,1911254,1844260,2161008,1610276,3755514
Bosnia and Herzegovina,2002,1912945,1846444,2151678,1624129,3759389
Bosnia and Herzegovina,2003,1914271,1847908,2141685,1637562,3762179
Bosnia and Herzegovina,2004,1915273,1848921,2130843,1650444,3764194
Bosnia and Herzegovina,2005,1915817,1849515,2118996,1662534,3765332
Bosnia and Herzegovina,2006,1915826,1849596,2105827,1673641,3765422
Bosnia and Herzegovina,2007,1914514,1848277,2090766,1683233,3762791
Bosnia and Herzegovina,2008,1910269,1843992,2072991,1690608,3754261
Bosnia and Herzegovina,2009,1901145,1834800,2051664,1694897,3735945
Bosnia and Herzegovina,2010,1885941,1819537,2026365,1695719,3705478
Bosnia and Herzegovina,2011,1863814,1797359,1996478,1692387,3661173
Bosnia and Herzegovina,2012,1835725,1769247,1962769,1685431,3604972
Bosnia and Herzegovina,2013,1804557,1738041,1927984,1677015,3542598
Bosnia and Herzegovina,2014,1774341,1707765,1895685,1670317,3482106
Bosnia and Herzegovina,2015,1748019,1681343,1867937,1668024,3429362
Bosnia and Herzegovina,2016,1726540,1659723,1845681,1671135,3386263
Bosnia and Herzegovina,2017,1709262,1642272,1828006,1679011,3351534
Bosnia and Herzegovina,2018,1695554,1628375,1813259,1690295,3323929
Botswana,2000,847900,795433,808537,919803,1643333
Botswana,2001,863288,811386,806191,948744,1674674
Botswana,2002,878119,826518,808627,971326,1704637
Botswana,2003,892835,841552,811427,992912,1734387
Botswana,2004,908062,857471,814278,1015052,1765533
Botswana,2005,924207,874870,817614,1038238,1799077
Botswana,2006,941550,894361,821528,1062710,1835911
Botswana,2007,959935,915523,805426,1108988,1875458
Botswana,2008,978824,936812,789368,1156983,1915636
Botswana,2009,997437,956058,773398,1206484,1953495
Botswana,2010,1015242,971864,757339,1257527,1987106
Botswana,2011,1031977,983429,741251,1310088,2015406
Botswana,2012,1047926,991624,736104,1353211,2039550
Botswana,2013,1063856,998695,732803,1395704,2062551
Botswana,2014,1080798,1007821,729332,1439241,2088619
Botswana,2015,1099500,1021216,725610,1483587,2120716
Botswana,2016,1120211,1039714,721580,1528680,2159925
Botswana,2017,1142607,1062469,717290,1574371,2205076
Botswana,2018,1166046,1088021,712875,1620326,2254067
Brazil,2000,88208705,86581634,32968080,142319507,174790339
Brazil,2001,89459431,87736620,32789771,144960898,177196051
Brazil,2002,90679052,88858471,32643261,147507760,179537523
Brazil,2003,91864663,89944581,32477004,150005145,181809244
Brazil,2004,93013715,90992764,32290174,152448284,184006479
Brazil,2005,94125016,92002092,32085721,154831640,186127108
Brazil,2006,95196581,92970772,31861129,157151283,188167353
Brazil,2007,96229936,93900509,31618718,159407919,190130445
Brazil,2008,97231896,94798466,31361744,161617285,192030362
Brazil,2009,98211956,95674549,31097565,163798431,193886505
Brazil,2010,99177368,96536269,30827251,165969018,195713637
Brazil,2011,100129355,97385186,30536433,168150255,197514541
Brazil,2012,101066961,98220331,30238865,170322118,199287292
Brazil,2013,101992473,99043431,29937266,172471366,201035904
Brazil,2014,102907992,99855752,29627255,174585878,202763744
Brazil,2015,103814243,100657516,29308408,176653700,204471759
Brazil,2016,104712864,101450192,28983278,178669587,206163056
Brazil,2017,105601737,102232088,28654406,180633872,207833825
Brazil,2018,106473081,102996239,28321495,182546459,209469320
Brunei Darussalam,2000,164416,168750,96095,237146,333166
Brunei Darussalam,2001,168022,172015,96416,243701,340037
Brunei Darussalam,2002,171179,175598,96965,249902,346777
Brunei Darussalam,2003,173952,179343,97461,255928,353295
Brunei Darussalam,2004,176429,183005,97812,261711,359434
Brunei Darussalam,2005,178683,186429,97998,267160,365112
Brunei Darussalam,2006,180728,189534,98010,272240,370262
Brunei Darussalam,2007,182568,192399,97871,276993,374967
Brunei Darussalam,2008,184299,195119,97651,281601,379418
Brunei Darussalam,2009,186047,197855,97449,286323,383902
Brunei Darussalam,2010,187915,200719,97318,291344,388634
Brunei Darussalam,2011,189944,203743,97280,296733,393687
Brunei Darussalam,2012,192127,206870,97314,302434,398997
Brunei Darussalam,2013,194417,209997,97386,308330,404414
Brunei Darussalam,2014,196756,213022,97441,314263,409778
Brunei Darussalam,2015,199086,215828,97440,320102,414914
Brunei Darussalam,2016,201415,218376,97378,325818,419791
Brunei Darussalam,2017,203753,220728,97263,331434,424481
Brunei Darussalam,2018,206056,222904,97106,336970,428960
Bulgaria,2000,4100255,3897696,2487423,5510364,7997951
Bulgaria,2001,4067851,3862849,2445343,5485203,7930700
Bulgaria,2002,4036378,3829864,2397299,5468787,7866242
Bulgaria,2003,4005709,3798597,2350579,5453302,7804306
Bulgaria,2004,3975713,3768917,2304921,5438343,7744630
Bulgaria,2005,3946312,3740652,2260279,5423484,7686964
Bulgaria,2006,3917337,3713683,2216404,5408555,7631020
Bulgaria,2007,3888806,3687869,2173353,5393596,7576675
Bulgaria,2008,3861041,3663043,2131248,5379083,7524084
Bulgaria,2009,3834483,3639026,2090438,5365591,7473509
Bulgaria,2010,3809379,3615632,2050944,5353646,7425011
Bulgaria,2011,3785857,3592795,2012821,5343392,7378652
Bulgaria,2012,3763643,3570364,1975613,5334770,7334007
Bulgaria,2013,3742131,3547961,1939116,5327025,7290092
Bulgaria,2014,3720491,3525157,1902938,5319207,7245648
Bulgaria,2015,3698105,3501634,1866828,5310568,7199739
Bulgaria,2016,3674740,3477208,1830702,5300792,7151948
Bulgaria,2017,3650509,3451943,1794614,5289957,7102452
Bulgaria,2018,3625521,3426089,1758643,5278205,7051610
Burkina Faso,2000,5906289,5701662,9536675,2071266,11607951
Burkina Faso,2001,6073090,5871499,9730105,2214482,11944589
Burkina Faso,2002,6245192,6047905,9925754,2367346,12293097
Burkina Faso,2003,6423210,6231414,10124154,2530467,12654624
Burkina Faso,2004,6607939,6422637,10325765,2704804,13030576
Burkina Faso,2005,6799932,6622003,10531202,2890728,13421935
Burkina Faso,2006,6999445,6829728,10739810,3089367,13829173
Burkina Faso,2007,7206343,7045686,10974579,3277442,14252029
Burkina Faso,2008,7420314,7269411,11232644,3457082,14689725
Burkina Faso,2009,7640862,7500236,11495301,3645798,15141098
Burkina Faso,2010,7867592,7737619,11761192,3844025,15605211
Burkina Faso,2011,8100461,7981454,12029972,4051932,16081915
Burkina Faso,2012,8339522,8231728,12301228,4269988,16571250
Burkina Faso,2013,8584578,8488213,12574710,4498013,17072791
Burkina Faso,2014,8835398,8750631,12849371,4736606,17586029
Burkina Faso,2015,9091844,9018772,13124769,4985855,18110616
Burkina Faso,2016,9353835,9292515,13400521,5245912,18646350
Burkina Faso,2017,9621388,9571848,13676652,5516730,19193236
Burkina Faso,2018,9894592,9856874,13952881,5798770,19751466
Burundi,2000,3246943,3131928,5872887,527819,6378871
Burundi,2001,3318648,3206898,6001113,554716,6525546
Burundi,2002,3406889,3297229,6156269,585300,6704118
Burundi,2003,3508789,3400372,6333751,619362,6909161
Burundi,2004,3619552,3512136,6526045,656406,7131688
Burundi,2005,3735550,3629307,6727349,695940,7364857
Burundi,2006,3856333,3751517,6937204,738134,7607850
Burundi,2007,3982782,3879444,7156384,783189,7862226
Burundi,2008,4114011,4012093,7381365,830899,8126104
Burundi,2009,4249199,4148462,7608188,880843,8397661
Burundi,2010,4387755,4287851,7833959,932971,8675606
Burundi,2011,4528952,4429454,8056443,987065,8958406
Burundi,2012,4672691,4573301,8276415,1043294,9245992
Burundi,2013,4819833,4720469,8497927,1102259,9540302
Burundi,2014,4971727,4872574,8726909,1164881,9844301
Burundi,2015,5129299,5030735,8967359,1231911,10160034
Burundi,2016,5292745,5195257,9220356,1303761,10488002
Burundi,2017,5461514,5365496,9483827,1380418,10827010
Burundi,2018,5634849,5540530,9754746,1461704,11175379
Cabo Verde,2000,222169,206009,202594,232485,428178
Cabo Verde,2001,225856,209845,202818,240898,435701
Cabo Verde,2002,229315,213640,202789,249317,442955
Cabo Verde,2003,232491,217434,202478,257668,449925
Cabo Verde,2004,235318,221301,201814,265850,456619
Cabo Verde,2005,237746,225288,200793,273774,463034
Cabo Verde,2006,239751,229420,199391,281404,469171
Cabo Verde,2007,241392,233675,197671,288767,475067
Cabo Verde,2008,242887,237959,195736,295987,480846
Cabo Verde,2009,244546,242121,193735,303228,486667
Cabo Verde,2010,246578,246066,191807,310577,492644
Cabo Verde,2011,249091,249767,191430,316637,498858
Cabo Verde,2012,251994,253247,191091,322888,505241
Cabo Verde,2013,255181,256559,190793,329313,511740
Cabo Verde,2014,258457,259819,190519,335918,518276
Cabo Verde,2015,261670,263070,190250,342663,524740
Cabo Verde,2016,264791,266349,190010,349550,531140
Cabo Verde,2017,267873,269626,189808,356580,537499
Cabo Verde,2018,270898,272866,189620,363715,543764
Cambodia,2000,6247771,5907470,9893668,2258686,12155241
Cambodia,2001,6378244,6027167,10082881,2319592,12405411
Cambodia,2002,6500497,6137222,10256921,2377808,12637719
Cambodia,2003,6615661,6240510,10419109,2434015,12856171
Cambodia,2004,6725421,6341054,10574098,2489279,13066475
Cambodia,2005,6831350,6442005,10725787,2544414,13273355
Cambodia,2006,6933488,6544217,10874842,2599647,13477705
Cambodia,2007,7032430,6647523,11021653,2655040,13679953
Cambodia,2008,7131010,6752825,11163903,2716606,13883835
Cambodia,2009,7232757,6860848,11282037,2808171,14093605
Cambodia,2010,7340155,6972050,11404934,2903806,14312205
Cambodia,2011,7454416,7087005,11533945,3003941,14541421
Cambodia,2012,7574842,7205612,11668224,3108642,14780454
Cambodia,2013,7699564,7326766,11805508,3217184,15026330
Cambodia,2014,7825697,7448809,11941876,3328914,15274506
Cambodia,2015,7950994,7570441,12074599,3443036,15521435
Cambodia,2016,8074999,7691291,12202907,3559463,15766290
Cambodia,2017,8198027,7811386,12327338,3678035,16009413
Cambodia,2018,8319566,7930228,12446208,3799521,16249794
Cameroon,2000,7791677,7722267,8318116,6956118,15513944
Cameroon,2001,7998955,7929955,8441086,7230841,15928910
Cameroon,2002,8212674,8144931,8567125,7517761,16357605
Cameroon,2003,8433249,8367620,8696474,7817348,16800869
Cameroon,2004,8661010,8598312,8828900,8130181,17259322
Cameroon,2005,8896229,8837179,8964620,8456175,17733408
Cameroon,2006,9139126,9084551,9103242,8796320,18223677
Cameroon,2007,9389810,9340473,9244465,9150924,18730283
Cameroon,2008,9648222,9604452,9387386,9519622,19252674
Cameroon,2009,9914162,9875760,9530836,9901705,19789922
Cameroon,2010,10187444,10153792,9673887,10296608,20341236
Cameroon,2011,10468054,10438338,9816164,10704283,20906392
Cameroon,2012,10755870,10729397,9957503,11124880,21485267
Cameroon,2013,11050423,11026877,10097480,11558235,22077300
Cameroon,2014,11351123,11330730,10235717,12004187,22681853
Cameroon,2015,11657496,11640880,10371907,12462615,23298376
Cameroon,2016,11969336,11957213,10505784,12933405,23926549
Cameroon,2017,12286573,12279497,10637190,13416537,24566070
Cameroon,2018,12609010,12607251,10766102,13912132,25216261
Canada,2000,15436061,15152318,6307700,24428073,30588379
Canada,2001,15580765,15299307,6263924,24760808,30880072
Canada,2002,15728925,15449335,6299155,25021734,31178260
Canada,2003,15882973,15605073,6336148,25291658,31488046
Canada,2004,16045711,15769779,6375632,25573785,31815490
Canada,2005,16218869,15945444,6418127,25869853,32164313
Canada,2006,16403555,16133439,6459512,26185971,32536994
Canada,2007,16598588,16332207,6473183,26546749,32930795
Canada,2008,16800443,16537195,6487802,26916746,33337638
Canada,2009,17004120,16741973,6501752,27288079,33746093
Canada,2010,17205758,16941808,6513437,27655231,34147566
Canada,2011,17404190,17134966,6529238,28009384,34539156
Canada,2012,17599688,17322343,6583389,28317316,34922031
Canada,2013,17791504,17505031,6635934,28619561,35296535
Canada,2014,17979215,17685123,6687150,28917578,35664338
Canada,2015,18162530,17864138,6737308,29212401,36026668
Canada,2016,18340847,18042095,6786280,29503542,36382942
Canada,2017,18513915,18218176,6830253,29793946,36732091
Canada,2018,18682437,18392121,6869269,30084496,37074558
Central African Republic,2000,1845398,1795023,2341659,1413327,3640421
Central African Republic,2001,1886113,1835903,2386683,1445520,3722016
Central African Republic,2002,1925842,1876287,2430450,1477162,3802129
Central African Republic,2003,1964888,1916297,2473248,1508417,3881185
Central African Republic,2004,2003719,1956164,2515494,1539542,3959883
Central African Republic,2005,2042502,1995878,2556449,1571461,4038380
Central African Republic,2006,2081976,2036099,2596960,1604798,4118075
Central African Republic,2007,2121636,2076368,2636499,1639301,4198004
Central African Republic,2008,2159049,2114319,2672155,1673231,4273368
Central African Republic,2009,2190888,2146735,2700048,1704182,4337623
Central African Republic,2010,2215124,2171641,2717873,1730652,4386765
Central African Republic,2011,2230666,2187973,2724400,1751753,4418639
Central African Republic,2012,2239125,2197286,2721724,1768692,4436411
Central African Republic,2013,2244484,2203461,2714965,1784688,4447945
Central African Republic,2014,2252275,2211896,2711077,1804315,4464171
Central African Republic,2015,2266606,2226565,2715046,1831054,4493171
Central African Republic,2016,2288847,2248836,2728393,1866228,4537683
Central African Republic,2017,2318147,2277876,2749797,1909283,4596023
Central African Republic,2018,2353555,2312820,2777836,1959587,4666375
Chad,2000,4196724,4158930,6537507,1805052,8355654
Chad,2001,4357454,4320595,6785780,1877232,8678049
Chad,2002,4527646,4491580,7048105,1953584,9019226
Chad,2003,4704628,4669285,7320248,2032953,9373913
Chad,2004,4884658,4850103,7596322,2113721,9734761
Chad,2005,5065134,5031496,7872263,2194746,10096630
Chad,2006,5244842,5212280,8146101,2275496,10457122
Chad,2007,5424702,5393329,8419328,2356380,10818031
Chad,2008,5606877,5576712,8695468,2438393,11183589
Chad,2009,5794635,5765507,8979786,2523000,11560142
Chad,2010,5990241,5961893,9273802,2613400,11952134
Chad,2011,6194441,6166545,9578480,2710171,12360986
Chad,2012,6406230,6378518,9891998,2813137,12784748
Chad,2013,6624061,6596372,10211686,2921903,13220433
Chad,2014,6845615,6817947,10533696,3035742,13663562
Chad,2015,7069237,7041734,10855197,3154216,14110971
Chad,2016,7294423,7267235,11175141,3277402,14561658
Chad,2017,7521758,7495003,11494121,3405873,15016761
Chad,2018,7752004,7725723,11812905,3540279,15477727
Chile,2000,7794185,7548165,2125607,13137147,15342350
Chile,2001,7882066,7634046,2106259,13338710,15516112
Chile,2002,7967282,7717131,2092618,13531017,15684413
Chile,2003,8051012,7798637,2106807,13692735,15849649
Chile,2004,8134816,7880156,2120588,13853190,16014972
Chile,2005,8219838,7962875,2134099,14012965,16182713
Chile,2006,8306862,8047644,2147356,14172436,16354506
Chile,2007,8395791,8134410,2160337,14331350,16530201
Chile,2008,8485911,8222343,2172928,14489014,16708254
Chile,2009,8576060,8310124,2185026,14644416,16886184
Chile,2010,8665530,8397001,2196490,14796864,17062531
Chile,2011,8752531,8481053,2207299,14946058,17233584
Chile,2012,8837489,8562870,2217485,15092261,17400359
Chile,2013,8924483,8647028,2227155,15235827,17571511
Chile,2014,9019145,8739824,2236368,15377430,17758969
Chile,2015,9124556,8844800,2245203,15517478,17969356
Chile,2016,9243814,8965258,2252605,15657149,18209072
Chile,2017,9373183,9097252,2258558,15796168,18470435
Chile,2018,9500750,9228416,2262995,15934214,18729166
China,2000,642750414,676800981,829403316,482727522,1319551395
China,2001,646962332,681378833,818630475,501452843,1328341165
China,2002,650962190,685802947,806104331,521893970,1336765137
China,2003,654804357,690103794,793136597,542756370,1344908151
China,2004,658556580,694314451,779706681,564037221,1352871031
China,2005,662272988,698461553,765903084,585633612,1360734541
China,2006,665971752,702556625,752299538,606988730,1368528377
China,2007,669659334,706606300,738685151,628350588,1376265634
China,2008,673361690,710623925,724760394,650038030,1383985615
China,2009,677103746,714621249,710632634,671961097,1391724995
China,2010,680899592,718603107,696249563,694170135,1399502699
China,2011,684755803,722568021,682518202,715762326,1407323824
China,2012,688660110,726504080,669007424,737124022,1415164190
China,2013,692581036,730390029,655323811,758533671,1422971065
China,2014,696473717,734197103,641352868,779954516,1430670820
China,2015,700297230,737896196,627097042,801263909,1438193426
China,2016,704042370,741481549,612549421,822422660,1445523919
China,2017,707692264,744932969,597816520,843314783,1452625233
China,2018,711188365,748189245,583199631,863601691,1459377610
Colombia,2000,20202658,19427307,10522282,29881676,39629965
Colombia,2001,20525349,19730607,10501653,30487256,40255956
Colombia,2002,20842746,20032617,10477378,31095113,40875363
Colombia,2003,21153274,20330598,10449169,31702982,41483872
Colombia,2004,21455009,20620944,10416017,32308146,42075953
Colombia,2005,21746639,20901092,10378127,32907506,42647731
Colombia,2006,22029131,21171770,10335155,33500567,43200901
Colombia,2007,22303332,21434180,10287615,34086957,43737512
Colombia,2008,22567928,21687044,10235594,34665950,44254972
Colombia,2009,22821214,21928840,10179227,35236954,44750054
Colombia,2010,23063041,22159658,10118665,35799432,45222699
Colombia,2011,23288625,22374122,10054003,36352643,45662747
Colombia,2012,23500706,22575015,9985405,36896070,46075721
Colombia,2013,23715462,22780030,9913190,37429791,46495492
Colombia,2014,23954672,23013034,9837737,37954174,46967706
Colombia,2015,24231886,23288781,9759346,38469351,47520667
Colombia,2016,24556894,23618154,9678238,38975181,48175048
Colombia,2017,24919763,23990081,9594518,39471097,48909844
Colombia,2018,25290276,24370780,9508270,39956413,49661056
Comoros,2000,269505,272853,390064,152293,542358
Comoros,2001,276169,279726,400041,155847,555895
Comoros,2002,282854,286626,410073,159406,569480
Comoros,2003,289619,293594,420218,162993,583213
Comoros,2004,296524,300706,430581,166647,597230
Comoros,2005,303613,308012,441134,170493,611625
Comoros,2006,310902,315525,451884,174541,626427
Comoros,2007,318386,323238,462822,178798,641624
Comoros,2008,326070,331157,473954,183275,657227
Comoros,2009,333967,339284,485270,187982,673251
Comoros,2010,342069,347627,496767,192925,689696
Comoros,2011,350390,356188,508448,198121,706578
Comoros,2012,358914,364951,520293,203575,723865
Comoros,2013,367616,373895,532229,209271,741511
Comoros,2014,376437,382953,544189,215196,759390
Comoros,2015,385346,392089,556090,221334,777435
Comoros,2016,394323,401274,567911,227690,795597
Comoros,2017,403368,410522,579639,234273,813890
Comoros,2018,412488,419834,591255,241092,832322
Congo,2000,1584091,1543329,1332387,1893340,3127420
Congo,2001,1628635,1589295,1354293,1961513,3217930
Congo,2002,1674007,1636369,1375924,2031256,3310376
Congo,2003,1721311,1685604,1398356,2104163,3406915
Congo,2004,1772069,1738399,1422945,2182494,3510468
Congo,2005,1827170,1795605,1450563,2267680,3622775
Congo,2006,1887302,1857841,1481568,2360797,3745143
Congo,2007,1951730,1924393,1515245,2461001,3876123
Congo,2008,2018345,1993142,1549624,2565811,4011487
Congo,2009,2084233,2061167,1582371,2671341,4145400
Congo,2010,2147328,2126410,1611866,2774827,4273738
Congo,2011,2206804,2188038,1637585,2875145,4394842
Congo,2012,2263417,2246780,1660183,2973180,4510197
Congo,2013,2318674,2304083,1680730,3070663,4622757
Congo,2014,2374824,2362141,1700765,3170336,4736965
Congo,2015,2433522,2422571,1721362,3274286,4856093
Congo,2016,2495201,2485795,1742734,3383087,4980996
Congo,2017,2559385,2551316,1764522,3496228,5110701
Congo,2018,2625622,2618741,1786495,3613400,5244363
Costa Rica,2000,1973722,1988647,1607403,2318040,3962369
Costa Rica,2001,2009976,2024098,1582349,2414449,4034074
Costa Rica,2002,2043743,2057179,1554034,2509170,4100922
Costa Rica,2003,2075608,2088445,1523324,2602647,4164053
Costa Rica,2004,2106442,2118714,1491084,2695954,4225156
Costa Rica,2005,2136918,2148586,1458203,2789638,4285504
Costa Rica,2006,2167187,2178234,1424705,2884089,4345421
Costa Rica,2007,2197124,2207502,1390626,2978843,4404626
Costa Rica,2008,2226713,2236410,1355892,3073616,4463123
Costa Rica,2009,2255890,2264849,1320650,3167613,4520739
Costa Rica,2010,2284596,2292775,1284690,3260590,4577371
Costa Rica,2011,2312869,2320217,1248208,3352266,4633086
Costa Rica,2012,2340768,2347235,1212562,3441560,4688003
Costa Rica,2013,2368302,2373809,1178012,3528389,4742111
Costa Rica,2014,2395474,2399916,1144604,3612971,4795390
Costa Rica,2015,2422275,2425530,1112422,3695430,4847805
Costa Rica,2016,2448697,2450639,1081494,3775780,4899336
Costa Rica,2017,2474720,2475235,1051813,3853956,4949955
Costa Rica,2018,2500214,2499229,1023354,3929845,4999443
Croatia,2000,2296428,2131647,2062239,2365833,4428075
Croatia,2001,2286749,2121324,2043497,2364583,4408073
Croatia,2002,2280419,2115383,2030408,2365411,4395802
Croatia,2003,2276413,2112496,2019844,2369102,4388909
Croatia,2004,2273241,2110636,2010143,2373777,4383877
Croatia,2005,2269751,2108315,2000102,2377955,4378066
Croatia,2006,2265636,2105146,1989394,2381305,4370782
Croatia,2007,2261031,2101396,1978228,2384038,4362427
Croatia,2008,2255834,2096804,1966449,2385979,4352638
Croatia,2009,2250022,2091239,1954051,2387033,4341261
Croatia,2010,2243557,2084606,1940974,2387179,4328163
Croatia,2011,2236385,2076713,1927119,2386252,4313098
Croatia,2012,2228364,2067505,1911684,2384842,4295869
Croatia,2013,2219313,2057280,1894797,2383009,4276593
Croatia,2014,2209053,2046465,1876612,2380921,4255518
Croatia,2015,2197469,2035405,1857290,2378726,4232874
Croatia,2016,2184475,2024136,1836858,2376407,4208611
Croatia,2017,2170190,2012657,1815373,2373980,4182847
Croatia,2018,2155206,2001201,1793077,2371706,4156407
Cuba,2000,5579325,5547098,2751655,8399081,11126423
Cuba,2001,5599861,5564815,2734588,8451954,11164676
Cuba,2002,5617539,5582125,2716433,8501565,11199664
Cuba,2003,5631843,5597342,2704756,8540129,11229185
Cuba,2004,5642192,5608177,2699495,8567446,11250369
Cuba,2005,5648371,5613215,2693118,8591135,11261586
Cuba,2006,5649794,5611447,2685454,8610779,11261241
Cuba,2007,5647112,5604005,2676725,8626962,11251117
Cuba,2008,5642859,5594116,2667669,8642085,11236975
Cuba,2009,5640438,5586273,2659312,8659290,11226711
Cuba,2010,5642215,5583618,2652264,8680787,11225833
Cuba,2011,5649261,5587410,2646885,8707766,11236671
Cuba,2012,5660661,5596451,2642849,8739297,11257112
Cuba,2013,5674335,5608387,2644532,8767635,11282722
Cuba,2014,5687218,5619691,2647001,8792766,11306909
Cuba,2015,5697027,5627750,2648084,8813348,11324777
Cuba,2016,5703178,5631930,2647509,8828473,11335108
Cuba,2017,5706299,5632956,2644108,8840528,11339255
Cuba,2018,5706812,5631334,2638265,8850817,11338146
Cyprus,2000,467861,475427,295736,647550,943288
Cyprus,2001,475702,484572,299901,660381,960274
Cyprus,2002,483117,493851,305847,671119,976968
Cyprus,2003,490494,503068,312451,681112,993562
Cyprus,2004,498402,512008,319186,691224,1010410
Cyprus,2005,507183,520474,326096,701562,1027657
Cyprus,2006,517083,528424,333253,712256,1045507
Cyprus,2007,527828,535880,340577,723135,1063708
Cyprus,2008,538701,542867,347846,733717,1081568
Cyprus,2009,548672,549417,354733,743343,1098089
Cyprus,2010,557035,555582,361031,751576,1112617
Cyprus,2011,563479,561358,366624,758211,1124837
Cyprus,2012,568305,566741,371602,763460,1135046
Cyprus,2013,572061,571805,375923,767973,1143866
Cyprus,2014,575624,576673,379900,772409,1152297
Cyprus,2015,579592,581395,383751,777234,1160987
Cyprus,2016,584159,586030,387536,782589,1170189
Cyprus,2017,589134,590551,391192,788359,1179685
Cyprus,2018,594287,594975,394652,794433,1189262
Czechia,2000,5283855,5005519,2676516,7613078,10289374
Czechia,2001,5274170,4996849,2683121,7588083,10271019
Czechia,2002,5264635,4987629,2685263,7567176,10252264
Czechia,2003,5257571,4981560,2688862,7550415,10239131
Czechia,2004,5255933,4983511,2695998,7543538,10239444
Czechia,2005,5261607,4996558,2707979,7550197,10258165
Czechia,2006,5275870,5022739,2725691,7572597,10298609
Czechia,2007,5297511,5060024,2748296,7608290,10357535
Czechia,2008,5322818,5102449,2773375,7650419,10425267
Czechia,2009,5346558,5141597,2797430,7689415,10488155
Czechia,2010,5364998,5171516,2817955,7718331,10536514
Czechia,2011,5376666,5189846,2834000,7734715,10566512
Czechia,2012,5382741,5198561,2837581,7749174,10581302
Czechia,2013,5385316,5201213,2829750,7764731,10586529
Czechia,2014,5387753,5203351,2820933,7777593,10591104
Czechia,2015,5392410,5208980,2812446,7791316,10601390
Czechia,2016,5399829,5219039,2804473,7806474,10618868
Czechia,2017,5409017,5232015,2795276,7823027,10641032
Czechia,2018,5419081,5246598,2784670,7840580,10665679
C√¥te d'Ivoire,2000,7975896,8478764,9485524,7201037,16454660
C√¥te d'Ivoire,2001,8183406,8669621,9616036,7424116,16853027
C√¥te d'Ivoire,2002,8382362,8849176,9728117,7638400,17231538
C√¥te d'Ivoire,2003,8576950,9022663,9829817,7849538,17599613
C√¥te d'Ivoire,2004,8773074,9197419,9931729,8066009,17970493
C√¥te d'Ivoire,2005,8975373,9379140,10042114,8294189,18354513
C√¥te d'Ivoire,2006,9185251,9569663,10162795,8536640,18754914
C√¥te d'Ivoire,2007,9402489,9768761,10292928,8793013,19171250
C√¥te d'Ivoire,2008,9628035,9977533,10433268,9064718,19605568
C√¥te d'Ivoire,2009,9862515,10196632,10584261,9352105,20059147
C√¥te d'Ivoire,2010,10106430,10426514,10745373,9655958,20532944
C√¥te d'Ivoire,2011,10360527,10668125,10917658,9977653,21028652
C√¥te d'Ivoire,2012,10625267,10921921,11100787,10317816,21547188
C√¥te d'Ivoire,2013,10900328,11187178,11292254,10674058,22087506
C√¥te d'Ivoire,2014,11185031,11462641,11487772,11043578,22647672
C√¥te d'Ivoire,2015,11478829,11747319,11682793,11425679,23226148
C√¥te d'Ivoire,2016,11781686,12041040,11876170,11819749,23822726
C√¥te d'Ivoire,2017,12093608,12343867,12068187,12226563,24437475
C√¥te d'Ivoire,2018,12414060,12655166,12259023,12646820,25069226
Democratic People's Republic of Korea,2000,11751350,11177728,9306352,13622723,22929078
Democratic People's Republic of Korea,2001,11853810,11279172,9370467,13761343,23132982
Democratic People's Republic of Korea,2002,11956240,11383213,9435113,13901568,23339453
Democratic People's Republic of Korea,2003,12056080,11486354,9498234,14040306,23542434
Democratic People's Republic of Korea,2004,12149457,11583283,9556633,14172865,23732740
Democratic People's Republic of Korea,2005,12233823,11670344,9608248,14295919,23904167
Democratic People's Republic of Korea,2006,12308370,11746496,9652459,14408638,24054866
Democratic People's Republic of Korea,2007,12374676,11813654,9690536,14512753,24188330
Democratic People's Republic of Korea,2008,12435394,11874749,9724246,14610900,24310143
Democratic People's Republic of Korea,2009,12494308,11934032,9737390,14725631,24428340
Democratic People's Republic of Korea,2010,12554222,11994618,9744048,14847551,24548840
Democratic People's Republic of Korea,2011,12615979,12057413,9751147,14971151,24673392
Democratic People's Republic of Korea,2012,12678990,12121648,9758191,15095843,24800638
Democratic People's Republic of Korea,2013,12742849,12186651,9765036,15220940,24929500
Democratic People's Republic of Korea,2014,12806616,12251177,9770814,15345549,25057793
Democratic People's Republic of Korea,2015,12869582,12314250,9775101,15468816,25183832
Democratic People's Republic of Korea,2016,12931820,12375845,9774246,15594374,25307665
Democratic People's Republic of Korea,2017,12993548,12436268,9768556,15722409,25429816
Democratic People's Republic of Korea,2018,13054278,12495328,9757856,15852816,25549606
Democratic Republic of the Congo,2000,23746689,23359141,30542153,16534234,47105830
Democratic Republic of the Congo,2001,24403745,24024789,31172281,17222057,48428534
Democratic Republic of the Congo,2002,25121036,24750634,31867429,17968327,49871670
Democratic Republic of the Congo,2003,25893609,25531974,32619349,18770684,51425583
Democratic Republic of the Congo,2004,26710607,26358262,33411557,19622660,53068869
Democratic Republic of the Congo,2005,27564081,27221813,34229993,20521483,54785894
Democratic Republic of the Congo,2006,28454736,28123310,35072910,21470101,56578046
Democratic Republic of the Congo,2007,29386784,29066903,35944533,22473029,58453687
Democratic Republic of the Congo,2008,30359388,30051807,36842282,23531326,60411195
Democratic Republic of the Congo,2009,31371535,31077037,37763464,24645971,62448572
Democratic Republic of the Congo,2010,32422236,32141617,38705362,25817901,64563853
Democratic Republic of the Congo,2011,33510549,33244602,39665446,27048151,66755151
Democratic Republic of the Congo,2012,34635680,34385069,40641055,28337627,69020749
Democratic Republic of the Congo,2013,35796890,35561914,41629125,29686908,71358804
Democratic Republic of the Congo,2014,36993480,36773965,42626472,31096388,73767445
Democratic Republic of the Congo,2015,38224572,38019960,43630111,32566508,76244532
Democratic Republic of the Congo,2016,39489787,39299343,44637912,34098241,78789130
Democratic Republic of the Congo,2017,40787891,40610874,45647604,35692384,81398765
Democratic Republic of the Congo,2018,42116217,41951875,46656050,37348939,84068092
Denmark,2000,2698297,2642895,795838,4545356,5341192
Denmark,2001,2706251,2651808,795683,4562379,5358059
Denmark,2002,2713230,2659568,792499,4580302,5372798
Denmark,2003,2719959,2667009,788673,4598295,5386968
Denmark,2004,2727436,2675318,779832,4622929,5402754
Denmark,2005,2736374,2685327,766864,4654838,5421701
Denmark,2006,2747016,2697277,756876,4687427,5444293
Denmark,2007,2759062,2710858,749746,4720211,5469920
Denmark,2008,2772095,2725636,742924,4754871,5497731
Denmark,2009,2785430,2740959,737584,4788863,5526389
Denmark,2010,2798566,2756283,733539,4821305,5554849
Denmark,2011,2811390,2771590,728151,4854722,5582980
Denmark,2012,2824020,2786889,721427,4889233,5610909
Denmark,2013,2836352,2801800,716440,4921377,5638152
Denmark,2014,2848322,2815877,713100,4950814,5664199
Denmark,2015,2859887,2828808,709587,4979108,5688695
Denmark,2016,2870945,2840401,705862,5006008,5711346
Denmark,2017,2881526,2850751,701971,5031580,5732277
Denmark,2018,2891838,2860293,697769,5056587,5752131
Djibouti,2000,356818,360759,168406,549178,717577
Djibouti,2001,365248,367771,171618,561093,733019
Djibouti,2002,373214,373733,174439,571782,746947
Djibouti,2003,380252,379387,176988,581627,759639
Djibouti,2004,385823,385776,179465,591287,771599
Djibouti,2005,389622,393626,182018,601236,783248
Djibouti,2006,391324,403230,184663,611545,794554
Djibouti,2007,391252,414204,187353,622049,805456
Djibouti,2008,390538,425823,190109,632825,816361
Djibouti,2009,390778,437042,192941,643899,827820
Djibouti,2010,393102,447092,195770,655376,840194
Djibouti,2011,397940,455731,198612,667325,853671
Djibouti,2012,404927,463209,201456,679729,868136
Djibouti,2013,413398,469898,204251,692437,883296
Djibouti,2014,422312,476395,206929,705235,898707
Djibouti,2015,430881,483117,209442,717972,913998
Djibouti,2016,438940,490177,211764,730569,929117
Djibouti,2017,446703,497397,213906,743079,944100
Djibouti,2018,454211,504712,215875,755533,958923
Dominican Republic,2000,4226670,4244647,3274904,5287718,8471317
Dominican Republic,2001,4287804,4310795,3255760,5441366,8598599
Dominican Republic,2002,4346856,4378118,3235194,5597091,8724974
Dominican Republic,2003,4404718,4445599,3174168,5793592,8850317
Dominican Republic,2004,4462660,4511784,3094744,6008254,8974444
Dominican Republic,2005,4521595,4575667,3014191,6223375,9097262
Dominican Republic,2006,4581822,4636859,2932247,6439091,9218681
Dominican Republic,2007,4643110,4695746,2849396,6654957,9338856
Dominican Republic,2008,4705133,4752946,2765725,6870795,9458079
Dominican Republic,2009,4767298,4809438,2681990,7085768,9576736
Dominican Republic,2010,4829193,4865924,2597931,7300054,9695117
Dominican Republic,2011,4890693,4922526,2524085,7503010,9813219
Dominican Republic,2012,4951906,4979010,2457254,7697696,9930916
Dominican Republic,2013,5012859,5035367,2390521,7890775,10048226
Dominican Republic,2014,5073656,5091526,2323582,8082262,10165182
Dominican Republic,2015,5134308,5147367,2256692,8271701,10281675
Dominican Republic,2016,5194798,5202940,2189850,8458941,10397738
Dominican Republic,2017,5254937,5258174,2123575,8643423,10513111
Dominican Republic,2018,5314402,5312745,2059693,8823303,10627147
Ecuador,2000,6315964,6365159,5013641,7614955,12681123
Ecuador,2001,6433427,6481233,5038399,7814356,12914660
Ecuador,2002,6548517,6594948,5082637,7989423,13143465
Ecuador,2003,6662346,6707332,5140934,8148667,13369678
Ecuador,2004,6776510,6819880,5199348,8310299,13596390
Ecuador,2005,6892161,6933678,5259140,8476093,13825839
Ecuador,2006,7009987,7049392,5320597,8646883,14059379
Ecuador,2007,7129752,7166802,5383366,8822087,14296554
Ecuador,2008,7250590,7285150,5446778,9000784,14535740
Ecuador,2009,7371185,7403227,5509980,9181295,14774412
Ecuador,2010,7490761,7520353,5572140,9362550,15011114
Ecuador,2011,7608327,7635558,5638262,9539093,15243885
Ecuador,2012,7724581,7749518,5707115,9712551,15474099
Ecuador,2013,7842413,7865060,5775237,9886310,15707473
Ecuador,2014,7965751,7986081,5842585,10060527,15951832
Ecuador,2015,8097063,8114959,5909194,10235174,16212022
Ecuador,2016,8237882,8253234,5974947,10410121,16491116
Ecuador,2017,8386317,8399038,6039811,10585047,16785355
Ecuador,2018,8537161,8547198,6101055,10762370,17084359
Egypt,2000,34181137,34650424,39988667,29917321,68831561
Egypt,2001,34828098,35324564,40711513,30515427,70152662
Egypt,2002,35475154,36009890,41457204,31132914,71485044
Egypt,2003,36122892,36703210,42217976,31763966,72826102
Egypt,2004,36772336,37399737,42982044,32399855,74172073
Egypt,2005,37425951,38097625,43742795,33035354,75523576
Egypt,2006,38080826,38792844,44493461,33665587,76873670
Egypt,2007,38741311,39490813,45274468,34262785,78232124
Egypt,2008,39425763,40210318,46096587,34857294,79636081
Egypt,2009,40158284,40976505,46973046,35491976,81134789
Egypt,2010,40955024,41806220,47925009,36182597,82761244
Egypt,2011,41822894,42706357,48961610,36935951,84529251
Egypt,2012,42753933,43668307,50100764,37712493,86422240
Egypt,2013,43730649,44674003,51286648,38520785,88404652
Egypt,2014,44727504,45697164,52480985,39331581,90424668
Egypt,2015,45724871,46717678,53654843,40123329,92442549
Egypt,2016,46717301,47729770,54799311,40889370,94447071
Egypt,2017,47706815,48735775,55893406,41659745,96442590
Egypt,2018,48690128,49733474,56938212,42437529,98423602
El Salvador,2000,3051738,2836192,2410885,3456741,5887930
El Salvador,2001,3077036,2849965,2394061,3511901,5927001
El Salvador,2002,3100543,2861596,2375312,3564991,5962139
El Salvador,2003,3122538,2871537,2355110,3616425,5994075
El Salvador,2004,3143437,2880364,2333904,3666871,6023801
El Salvador,2005,3163573,2888551,2312232,3716729,6052124
El Salvador,2006,3183092,2896303,2290130,3766348,6079395
El Salvador,2007,3202064,2903746,2264614,3818861,6105810
El Salvador,2008,3220666,2911101,2219385,3890916,6131767
El Salvador,2009,3239061,2918617,2174461,3962815,6157678
El Salvador,2010,3257398,2926479,2129728,4034898,6183877
El Salvador,2011,3275742,2934825,2085360,4107200,6210567
El Salvador,2012,3294183,2943739,2041361,4179885,6237922
El Salvador,2013,3312806,2953270,1997999,4252778,6266076
El Salvador,2014,3331687,2963437,1955077,4326112,6295124
El Salvador,2015,3350892,2974229,1912681,4399797,6325121
El Salvador,2016,3370447,2985690,1871635,4473087,6356137
El Salvador,2017,3390314,2997810,1832049,4545804,6388124
El Salvador,2018,3410312,3010428,1793751,4617807,6420740
Equatorial Guinea,2000,291757,314423,312737,301586,606180
Equatorial Guinea,2001,302531,329131,314556,325206,631662
Equatorial Guinea,2002,313818,344570,316058,350349,658388
Equatorial Guinea,2003,325703,360967,317389,377222,686670
Equatorial Guinea,2004,338312,378637,318680,406137,716949
Equatorial Guinea,2005,351730,397797,320042,437275,749527
Equatorial Guinea,2006,365982,418512,321395,470822,784494
Equatorial Guinea,2007,381027,440659,322609,506718,821686
Equatorial Guinea,2008,396805,464034,323525,544893,860839
Equatorial Guinea,2009,413231,488358,324029,585082,901589
Equatorial Guinea,2010,430239,513400,323947,627157,943639
Equatorial Guinea,2011,447795,539066,323268,671022,986861
Equatorial Guinea,2012,465874,565317,321964,716629,1031191
Equatorial Guinea,2013,484414,591998,330070,753676,1076412
Equatorial Guinea,2014,503346,618927,337895,791529,1122273
Equatorial Guinea,2015,522589,645986,345376,830013,1168575
Equatorial Guinea,2016,542111,673070,352550,868940,1215181
Equatorial Guinea,2017,561894,700114,359435,908254,1262008
Equatorial Guinea,2018,581912,727054,366013,947881,1308966
Eritrea,2000,1151345,1141068,2490747,902054,2292413
Eritrea,2001,1192142,1182579,2537002,960122,2374721
Eritrea,2002,1244879,1236180,2590231,1024407,2481059
Eritrea,2003,1304366,1296606,2645064,1093201,2600972
Eritrea,2004,1363325,1356484,2694690,1163933,2719809
Eritrea,2005,1416324,1410329,2734684,1234323,2826653
Eritrea,2006,1461749,1456460,2763263,1303385,2918209
Eritrea,2007,1500626,1495914,2782012,1371320,2996540
Eritrea,2008,1533460,1529322,2793540,1439096,3062782
Eritrea,2009,1561642,1558278,2819613,1490721,3119920
Eritrea,2010,1586365,1584072,2846355,1544485,3170437
Eritrea,2011,1607405,1606564,2874045,1600645,3213969
Eritrea,2012,1624599,1625505,2902040,1658937,3250104
Eritrea,2013,1639350,1642103,2931111,1719887,3281453
Eritrea,2014,1653491,1657953,2961994,1784051,3311444
Eritrea,2015,1668488,1674330,2995125,1851851,3342818
Eritrea,2016,1684859,1691699,3030917,1923728,3376558
Eritrea,2017,1702691,1710203,3069110,1999721,3412894
Eritrea,2018,1722421,1730376,3108634,2079313,3452797
Estonia,2000,746552,652559,428571,970541,1399111
Estonia,2001,742511,649228,428064,963665,1391739
Estonia,2002,738160,644577,427045,955687,1382737
Estonia,2003,733682,639222,425752,947157,1372904
Estonia,2004,729446,634124,424589,938976,1363570
Estonia,2005,725664,629986,423848,931800,1355650
Estonia,2006,722409,626964,423584,925713,1349373
Estonia,2007,719506,624789,423663,920409,1344295
Estonia,2008,716859,623208,424008,915704,1340067
Estonia,2009,714316,621824,424493,911337,1336140
Estonia,2010,711747,620356,425023,907079,1332103
Estonia,2011,709057,618644,425571,902878,1327701
Estonia,2012,706321,616842,424323,900611,1323163
Estonia,2013,703728,615340,421292,900268,1319068
Estonia,2014,701595,614678,418329,900030,1316273
Estonia,2015,700105,615225,415431,899890,1315330
Estonia,2016,699361,617146,412594,899848,1316507
Estonia,2017,699217,620172,409687,899945,1319389
Estonia,2018,699271,623642,406671,900117,1322913
Eswatini,2000,521948,483483,820663,240805,1005431
Eswatini,2001,526809,486799,830923,242004,1013608
Eswatini,2002,530770,488284,838528,242402,1019054
Eswatini,2003,534202,488594,844950,242442,1022796
Eswatini,2004,537611,488676,852319,242734,1026287
Eswatini,2005,541344,489231,862160,243713,1030575
Eswatini,2006,545599,490496,875009,245505,1036095
Eswatini,2007,550271,492380,889921,248513,1042651
Eswatini,2008,554984,494964,903417,255480,1049948
Eswatini,2009,559229,498233,917837,262838,1057462
Eswatini,2010,562655,502186,932443,270400,1064841
Eswatini,2011,565141,506888,947124,278134,1072029
Eswatini,2012,566906,512379,962964,285194,1079285
Eswatini,2013,568304,518539,979039,292417,1086843
Eswatini,2014,569814,525208,995295,299802,1095022
Eswatini,2015,571808,532230,1011681,307330,1104038
Eswatini,2016,574397,539597,1028022,315075,1113994
Eswatini,2017,577530,547278,1044238,323016,1124808
Eswatini,2018,581192,555082,1060246,331139,1136274
Ethiopia,2000,33205381,33019427,56730042,9807289,66224808
Ethiopia,2001,34174168,33985254,58268076,10224181,68159422
Ethiopia,2002,35166728,34975362,59839634,10657558,70142090
Ethiopia,2003,36182058,35988523,61438556,11106588,72170581
Ethiopia,2004,37217654,37021854,63054369,11570036,74239508
Ethiopia,2005,38272232,38074078,64680710,12046373,76346310
Ethiopia,2006,39345273,39143932,66314611,12536077,78489205
Ethiopia,2007,40439539,40234804,67946189,13054220,80674343
Ethiopia,2008,41560859,41355377,69451069,13733823,82916236
Ethiopia,2009,42716829,42517094,70972092,14444161,85233923
Ethiopia,2010,43912483,43727479,72513530,15189140,87639962
Ethiopia,2011,45150001,44989927,74076738,15970018,90139928
Ethiopia,2012,46426769,46300213,75656319,16787864,92726982
Ethiopia,2013,47737068,47648725,77262426,17625298,95385793
Ethiopia,2014,49072577,49021687,78869363,18497411,98094264
Ethiopia,2015,50426864,50408589,80469946,19403087,100835453
Ethiopia,2016,51797604,51805857,82059981,20343215,103603461
Ethiopia,2017,53185201,53214725,83640582,21316856,106399926
Ethiopia,2018,54589146,54635264,85207113,22327769,109224410
Fiji,2000,399035,411976,422583,388640,811011
Fiji,2001,400248,413675,420952,393266,813923
Fiji,2002,400580,414677,418511,397180,815257
Fiji,2003,400598,415480,415784,400844,816078
Fiji,2004,401094,416770,413443,404911,817864
Fiji,2005,402598,419008,411967,409850,821606
Fiji,2006,405414,422455,411520,415891,827869
Fiji,2007,409282,426903,411920,422892,836185
Fiji,2008,413666,431690,412007,431333,845356
Fiji,2009,417719,435917,411856,440111,853636
Fiji,2010,420873,438943,411306,448644,859816
Fiji,2011,422919,440532,410276,456810,863451
Fiji,2012,424107,440958,408880,464716,865065
Fiji,2013,424843,440759,407254,472461,865602
Fiji,2014,425740,440707,405553,480253,866447
Fiji,2015,427260,441372,403912,488237,868632
Fiji,2016,429493,442913,402329,496431,872406
Fiji,2017,432310,445150,400760,504742,877460
Fiji,2018,435565,447925,399125,513116,883490
Finland,2000,2655375,2532578,924351,4263603,5187953
Finland,2001,2660488,2539987,916956,4283523,5200475
Finland,2002,2665752,2547616,912167,4301206,5213368
Finland,2003,2671411,2555695,907532,4319571,5227106
Finland,2004,2677736,2564439,903126,4339059,5242175
Finland,2005,2684927,2574006,899025,4359902,5258933
Finland,2006,2693038,2584452,895236,4382334,5277490
Finland,2007,2702019,2595722,891744,4406270,5297741
Finland,2008,2711722,2607730,888472,4431430,5319452
Finland,2009,2721945,2620321,885348,4457298,5342266
Finland,2010,2732453,2633331,870880,4494902,5365784
Finland,2011,2743269,2646767,845427,4543815,5390036
Finland,2012,2754271,2660498,820527,4592453,5414769
Finland,2013,2765005,2673979,808694,4627922,5438984
Finland,2014,2774892,2686518,809393,4650324,5461410
Finland,2015,2783513,2697615,809950,4672016,5481128
Finland,2016,2790670,2707044,810329,4692803,5497714
Finland,2017,2796459,2714913,810547,4712684,5511372
Finland,2018,2801097,2721488,810217,4732300,5522585
France,2000,30389647,28625445,14382604,45225597,59015092
France,2001,30592499,28791627,14302809,45608443,59384126
France,2002,30822098,28981336,14224922,46000154,59803434
France,2003,31065902,29185689,14149190,46400907,60251591
France,2004,31306172,29391805,14075407,46811200,60697977
France,2005,31529984,29590144,14003975,47229925,61120128
France,2006,31732146,29776778,13934413,47658471,61508924
France,2007,31915779,29953450,13866281,48094669,61869229
France,2008,32086284,30122923,13794705,48534862,62209207
France,2009,32252636,30290247,13717697,48969824,62542883
France,2010,32420996,30458539,13633442,49393298,62879535
France,2011,32593041,30629188,13541366,49802211,63222229
France,2012,32765168,30799056,13442096,50197777,63564224
France,2013,32932072,30961448,13336757,50583160,63893520
France,2014,33086207,31107343,13226977,50963661,64193550
France,2015,33222436,31230758,13113960,51343241,64453194
France,2016,33338953,31328637,12998038,51722652,64667590
France,2017,33438277,31404236,12879012,52100536,64842513
France,2018,33524862,31465650,12756906,52476365,64990512
Gabon,2000,618056,610303,260031,971091,1228359
Gabon,2001,632195,625813,257087,1005172,1258008
Gabon,2002,646740,641570,254120,1040289,1288310
Gabon,2003,661899,658047,251249,1076897,1319946
Gabon,2004,677959,675829,248580,1115625,1353788
Gabon,2005,695156,695394,246218,1156908,1390550
Gabon,2006,713412,716732,244076,1200768,1430144
Gabon,2007,732793,739772,242107,1247086,1472565
Gabon,2008,753750,764788,240309,1296102,1518538
Gabon,2009,776855,792070,238727,1348027,1568925
Gabon,2010,802430,821716,237291,1402919,1624146
Gabon,2011,830699,853930,236029,1461072,1684629
Gabon,2012,861328,888349,234816,1522001,1749677
Gabon,2013,893274,923796,233402,1583869,1817070
Gabon,2014,925129,958672,231633,1644080,1883801
Gabon,2015,955859,991831,229341,1700834,1947690
Gabon,2016,985073,1022809,226498,1753288,2007882
Gabon,2017,1012977,1051835,223245,1801892,2064812
Gabon,2018,1039898,1079376,219785,1847776,2119274
Gambia,2000,661441,656267,642181,589663,1317708
Gambia,2001,683177,676893,650815,619680,1360070
Gambia,2002,705781,698482,659831,651518,1404263
Gambia,2003,729073,720852,669586,684608,1449925
Gambia,2004,752805,743719,681267,717306,1496524
Gambia,2005,776828,766917,692935,751269,1543745
Gambia,2006,801066,790378,704493,786528,1591444
Gambia,2007,825627,814219,715979,823137,1639846
Gambia,2008,850683,838605,727394,861178,1689288
Gambia,2009,876500,863777,738840,900720,1740277
Gambia,2010,903279,889920,750273,941876,1793199
Gambia,2011,931060,917082,761696,984667,1848142
Gambia,2012,959817,945203,773029,1029096,1905020
Gambia,2013,989462,974246,784258,1075066,1963708
Gambia,2014,1019942,1004095,795364,1122488,2024037
Gambia,2015,1051160,1034700,806309,1171281,2085860
Gambia,2016,1083106,1066028,817075,1221426,2149134
Gambia,2017,1115804,1098096,827654,1272914,2213900
Gambia,2018,1149215,1130877,838035,1325730,2280092
Georgia,2000,2289945,2072239,2236449,2485610,4362184
Georgia,2001,2253811,2043170,2224052,2448110,4296981
Georgia,2002,2231940,2026633,2199528,2425352,4258573
Georgia,2003,2220210,2018720,2159971,2419111,4238930
Georgia,2004,2212265,2013546,2120781,2412548,4225811
Georgia,2005,2203388,2006770,2081534,2405012,4210158
Georgia,2006,2192511,1997211,2042246,2396650,4189722
Georgia,2007,2180831,1986029,2003024,2387511,4166860
Georgia,2008,2168655,1973993,1963424,2377090,4142648
Georgia,2009,2156859,1962631,1923027,2364669,4119490
Georgia,2010,2146086,1953010,1881610,2350051,4099096
Georgia,2011,2135967,1945045,1838725,2332531,4081012
Georgia,2012,2126018,1938079,1794943,2312776,4064097
Georgia,2013,2116718,1931983,1752471,2293439,4048701
Georgia,2014,2108711,1926599,1714022,2278324,4035310
Georgia,2015,2102432,1921748,1681437,2270087,4024180
Georgia,2016,2098036,1917421,1655077,2270328,4015457
Georgia,2017,2095201,1913522,1634019,2278042,4008723
Georgia,2018,2093190,1909756,1616295,2290836,4002946
Germany,2000,41760376,39640507,20400344,61087413,81400883
Germany,2001,41757988,39695906,20245265,61290583,81453894
Germany,2002,41771775,39763349,20097558,61514310,81535124
Germany,2003,41785913,39828458,19950126,61736369,81614371
Germany,2004,41776787,39869687,19792081,61923578,81646474
Germany,2005,41729268,39873471,19617625,62053609,81602739
Germany,2006,41637481,39834754,19423458,62116895,81472235
Germany,2007,41513060,39764776,19215385,62129072,81277836
Germany,2008,41379657,39686094,19004672,62126272,81065751
Germany,2009,41270117,39629844,18807360,62158252,80899961
Germany,2010,41208187,39618814,18633173,62261612,80827001
Germany,2011,41198865,39656764,18485321,62448659,80855629
Germany,2012,41235059,39737570,18507405,62558823,80972629
Germany,2013,41313075,39861298,18544700,62720439,81174373
Germany,2014,41425074,40025296,18587788,62901872,81450370
Germany,2015,41562835,40224576,18629376,63078413,81787411
Germany,2016,41729488,40464282,18657193,63257479,82193770
Germany,2017,41920684,40737725,18672100,63442124,82658409
Germany,2018,42111133,41013280,18671111,63622346,83124413
Ghana,2000,9548140,9730710,10619132,8319629,19278850
Ghana,2001,9783588,9973341,10759435,8662170,19756929
Ghana,2002,10024594,10221782,10903660,9020862,20246376
Ghana,2003,10272585,10477723,11051200,9395582,20750308
Ghana,2004,10529202,10743126,11200504,9786032,21272328
Ghana,2005,10795452,11019196,11350899,10191110,21814648
Ghana,2006,11072180,11306877,11501626,10611799,22379057
Ghana,2007,11358621,11605325,11652304,11047908,22963946
Ghana,2008,11652113,11911719,11800555,11498085,23563832
Ghana,2009,11948891,12222052,11944412,11959419,24170943
Ghana,2010,12246228,12533386,12081325,12430779,24779614
Ghana,2011,12543077,12844636,12210704,12911092,25387713
Ghana,2012,12840075,13156379,12333058,13399991,25996454
Ghana,2013,13138221,13469420,12449163,13897088,26607641
Ghana,2014,13439246,13785234,12559438,14403125,27224480
Ghana,2015,13744367,14104836,12664366,14918455,27849203
Ghana,2016,14053716,14428231,12763904,15442824,28481947
Ghana,2017,14366665,14754799,12857864,15975765,29121464
Ghana,2018,14682873,15084235,12946423,16517220,29767108
Greece,2000,5573768,5508335,3040042,8102077,11082103
Greece,2001,5602546,5531901,3029532,8154866,11134447
Greece,2002,5630045,5552263,2994553,8222245,11182308
Greece,2003,5652932,5565947,2958243,8285324,11218879
Greece,2004,5666695,5568298,2922112,8348364,11234993
Greece,2005,5668383,5556417,2887279,8413925,11224800
Greece,2006,5656593,5528638,2854291,8484479,11185231
Greece,2007,5633101,5487270,2822571,8558326,11120371
Greece,2008,5602025,5438287,2790077,8629570,11040312
Greece,2009,5569245,5390023,2754332,8689496,10959268
Greece,2010,5539087,5348553,2713565,8732440,10887640
Greece,2011,5512990,5316084,2667285,8755520,10829074
Greece,2012,5489994,5291125,2616562,8761695,10781119
Greece,2013,5469140,5271361,2563761,8757539,10740501
Greece,2014,5448563,5252897,2511810,8752916,10701460
Greece,2015,5426881,5232856,2462743,8755057,10659737
Greece,2016,5404211,5210972,2417151,8766565,10615183
Greece,2017,5381180,5188269,2374332,8785441,10569449
Greece,2018,5357527,5164717,2333390,8808771,10522244
Grenada,2000,51694,51143,65343,36276,102837
Grenada,2001,51830,51412,65265,36584,103242
Grenada,2002,51948,51688,65432,36668,103636
Grenada,2003,52037,51966,65615,36760,104003
Grenada,2004,52107,52239,65801,36855,104346
Grenada,2005,52165,52493,65995,36954,104658
Grenada,2006,52206,52732,66200,37059,104938
Grenada,2007,52236,52947,66416,37170,105183
Grenada,2008,52288,53169,66643,37287,105457
Grenada,2009,52382,53405,66884,37412,105787
Grenada,2010,52560,53667,67134,37543,106227
Grenada,2011,52821,53965,67396,37679,106786
Grenada,2012,53164,54288,67646,37835,107452
Grenada,2013,53548,54624,67892,38017,108172
Grenada,2014,53939,54961,68136,38224,108900
Grenada,2015,54314,55289,68370,38453,109603
Grenada,2016,54665,55598,68605,38712,110263
Grenada,2017,54983,55891,68831,38994,110874
Grenada,2018,55287,56162,69042,39297,111449
Guatemala,2000,5934007,5716737,6369284,5281459,11650744
Guatemala,2001,6076426,5848515,6479081,5445865,11924941
Guatemala,2002,6222528,5986326,6592165,5616683,12208854
Guatemala,2003,6371479,6129000,6710484,5789994,12500479
Guatemala,2004,6522089,6274837,6831542,5965383,12796926
Guatemala,2005,6673511,6422517,6952320,6143708,13096028
Guatemala,2006,6825375,6571647,7072229,6324779,13397022
Guatemala,2007,6977887,6722439,7191525,6508761,13700326
Guatemala,2008,7131454,6874966,7310395,6695971,14006420
Guatemala,2009,7286738,7029513,7429485,6886723,14316251
Guatemala,2010,7444184,7186236,7548904,7081513,14630420
Guatemala,2011,7603818,7344974,7668633,7280286,14948792
Guatemala,2012,7765347,7505427,7788239,7482817,15270774
Guatemala,2013,7928426,7667395,7905605,7690609,15595821
Guatemala,2014,8092579,7830659,8019984,7903575,15923238
Guatemala,2015,8257424,7995000,8130972,8121457,16252424
Guatemala,2016,8422799,8160280,8238270,8344199,16583079
Guatemala,2017,8588646,8326333,8341671,8571832,16914979
Guatemala,2018,8754899,8492956,8440970,8804376,17247855
Guinea,2000,4306936,3933799,6089434,2719112,8240735
Guinea,2001,4400834,4016248,6177192,2793947,8417082
Guinea,2002,4490274,4095803,6266378,2870967,8586077
Guinea,2003,4578296,4174801,6358823,2951025,8753097
Guinea,2004,4669211,4256518,6455507,3034722,8925729
Guinea,2005,4766168,4343417,6557321,3122424,9109585
Guinea,2006,4870609,4436812,6666117,3215311,9307421
Guinea,2007,4981776,4536383,6782797,3313930,9518159
Guinea,2008,5097790,4641006,6905524,3417618,9738796
Guinea,2009,5215735,4748735,7031556,3524968,9964470
Guinea,2010,5333703,4858465,7158911,3635259,10192168
Guinea,2011,5450929,4969530,7286986,3748184,10420459
Guinea,2012,5568785,5083247,7416978,3864491,10652032
Guinea,2013,5690062,5202759,7551293,3985322,10892821
Guinea,2014,5818608,5332362,7692904,4112604,11150970
Guinea,2015,5957128,5474968,7842402,4249131,11432096
Guinea,2016,6106627,5631807,8000301,4395623,11738434
Guinea,2017,6266010,5801506,8165321,4551855,12067516
Guinea,2018,6433224,5981068,8335437,4717171,12414292
Guinea-Bissau,2000,620459,580846,792644,450585,1201305
Guinea-Bissau,2001,634097,593008,803320,464192,1227105
Guinea-Bissau,2002,648621,605833,814873,478650,1254454
Guinea-Bissau,2003,663905,619392,827250,493952,1283297
Guinea-Bissau,2004,679741,633751,840298,510047,1313492
Guinea-Bissau,2005,695971,648960,853949,526889,1344931
Guinea-Bissau,2006,712541,665041,868159,544510,1377582
Guinea-Bissau,2007,729537,682008,882992,562966,1411545
Guinea-Bissau,2008,747084,699852,898503,582338,1446936
Guinea-Bissau,2009,765378,718542,914777,602671,1483920
Guinea-Bissau,2010,784555,738048,931806,624074,1522603
Guinea-Bissau,2011,804636,758360,949585,646569,1562996
Guinea-Bissau,2012,825548,779433,968011,670128,1604981
Guinea-Bissau,2013,847112,801147,986863,694632,1648259
Guinea-Bissau,2014,869094,823339,1005842,719902,1692433
Guinea-Bissau,2015,891313,845894,1024727,745799,1737207
Guinea-Bissau,2016,913702,868732,1043425,772272,1782434
Guinea-Bissau,2017,936281,891865,1061947,799336,1828146
Guinea-Bissau,2018,959059,915245,1080274,826994,1874304
Guyana,2000,374624,372094,537149,216152,746718
Guyana,2001,373068,372138,537070,215193,745206
Guyana,2002,372163,372626,537460,214424,744789
Guyana,2003,371852,373290,539030,212827,745142
Guyana,2004,371948,373789,540711,210941,745737
Guyana,2005,372284,373872,542015,208931,746156
Guyana,2006,372888,373447,542846,206755,746335
Guyana,2007,373823,372654,543379,204490,746477
Guyana,2008,374966,371849,544026,202288,746815
Guyana,2009,376211,371507,545333,200360,747718
Guyana,2010,377477,371953,547720,198836,749430
Guyana,2011,378715,373314,551338,197762,752029
Guyana,2012,379930,375458,554275,198816,755388
Guyana,2013,381144,378137,557948,200133,759281
Guyana,2014,382395,380976,561752,201641,763371
Guyana,2015,383716,383717,565310,203204,767433
Guyana,2016,385101,386262,568513,204790,771363
Guyana,2017,386540,388678,571434,206425,775218
Guyana,2018,388008,390999,574102,208123,779007
Haiti,2000,4296267,4167535,5505685,3043515,8463802
Haiti,2001,4369302,4239508,5454493,3238074,8608810
Haiti,2002,4442475,4311673,5394951,3439782,8754148
Haiti,2003,4515915,4384193,5328009,3648543,8900108
Haiti,2004,4589794,4457288,5318404,3800774,9047082
Haiti,2005,4664202,4531087,5313686,3949718,9195289
Haiti,2006,4739173,4605611,5306584,4102872,9344784
Haiti,2007,4814610,4680726,5296958,4259931,9495336
Haiti,2008,4890335,4756235,5284322,4420707,9646570
Haiti,2009,4966143,4831903,5268561,4584309,9798046
Haiti,2010,5041823,4907495,5248935,4750682,9949318
Haiti,2011,5117317,4983003,5225560,4919494,10100320
Haiti,2012,5192578,5058344,5198418,5090792,10250922
Haiti,2013,5267506,5133166,5167888,5263888,10400672
Haiti,2014,5342001,5207006,5133539,5438927,10549007
Haiti,2015,5415970,5279570,5095543,5615518,10695540
Haiti,2016,5489355,5350621,5055343,5791991,10839976
Haiti,2017,5562083,5420284,5013421,5967808,10982367
Haiti,2018,5634138,5489045,4969937,6143008,11123183
Honduras,2000,3305010,3269500,3558472,2965811,6574510
Honduras,2001,3393288,3358624,3616670,3076391,6751912
Honduras,2002,3481411,3447856,3664258,3198899,6929267
Honduras,2003,3569279,3537044,3709119,3324702,7106323
Honduras,2004,3656850,3626103,3751429,3452724,7282953
Honduras,2005,3744050,3714932,3791031,3582399,7458982
Honduras,2006,3830839,3803456,3827638,3713768,7634295
Honduras,2007,3917032,3891488,3861301,3846671,7808520
Honduras,2008,4002312,3978643,3891762,3980896,7980955
Honduras,2009,4086319,4064461,3919075,4115946,8150780
Honduras,2010,4168823,4148644,3942955,4251823,8317467
Honduras,2011,4249670,4231000,3963389,4388211,8480670
Honduras,2012,4329000,4311692,3980456,4525190,8640692
Honduras,2013,4407287,4391237,3994867,4662918,8798524
Honduras,2014,4485195,4470384,4006997,4802219,8955579
Honduras,2015,4563218,4549686,4017554,4943275,9112904
Honduras,2016,4641497,4629297,4026684,5086183,9270794
Honduras,2017,4719923,4709093,4034310,5230757,9429016
Honduras,2018,4798492,4789031,4040365,5376802,9587523
Hungary,2000,5358038,4862471,3620820,6600231,10220509
Hungary,2001,5347078,4846373,3601587,6592418,10193451
Hungary,2002,5336288,4830998,3550560,6617312,10167286
Hungary,2003,5325239,4816102,3500049,6641907,10141341
Hungary,2004,5313236,4801245,3449597,6665484,10114481
Hungary,2005,5299805,4786137,3392629,6693836,10085942
Hungary,2006,5284906,4770751,3329016,6726881,10055657
Hungary,2007,5268849,4755309,3265684,6758203,10024158
Hungary,2008,5251902,4739965,3202837,6788364,9991867
Hungary,2009,5234478,4724961,3141050,6817892,9959439
Hungary,2010,5216909,4710471,3086495,6841345,9927380
Hungary,2011,5199205,4696484,3033021,6865183,9895689
Hungary,2012,5181388,4682975,2992731,6876953,9864363
Hungary,2013,5163835,4670088,2957147,6884550,9833923
Hungary,2014,5147018,4657973,2921708,6891627,9804991
Hungary,2015,5131209,4646716,2886258,6897667,9777925
Hungary,2016,5116595,4636375,2850043,6903238,9752970
Hungary,2017,5103006,4626816,2813212,6908347,9729822
Hungary,2018,5089879,4617623,2775785,6913062,9707502
Iceland,2000,140100,140339,21310,259125,280439
Iceland,2001,141340,141570,21127,261779,282910
Iceland,2002,142520,142809,20939,264390,285329
Iceland,2003,143781,144174,20765,267187,287955
Iceland,2004,145259,145843,20627,270477,291102
Iceland,2005,147070,147906,20539,274440,294976
Iceland,2006,149273,150454,20506,279222,299727
Iceland,2007,151794,153387,20516,284684,305181
Iceland,2008,154428,156427,20533,290351,310855
Iceland,2009,156877,159180,20512,295574,316057
Iceland,2010,158960,161382,20583,299745,320342
Iceland,2011,160567,162904,20740,302678,323471
Iceland,2012,161790,163852,20834,304692,325642
Iceland,2013,162748,164446,20820,306209,327194
Iceland,2014,163619,164973,20802,307657,328592
Iceland,2015,164552,165685,20805,309438,330237
Iceland,2016,165565,166644,20828,311646,332209
Iceland,2017,166634,167761,20862,314163,334395
Iceland,2018,167722,168990,20899,316881,336712
India,2000,507187684,549387864,761700630,291350282,1056575548
India,2001,515957249,559042845,772339048,299138807,1075000094
India,2002,524676537,568640650,782001968,307805144,1093317187
India,2003,533346647,578176499,791442579,316585269,1111523146
India,2004,541973982,587649484,800652720,325483057,1129623466
India,2005,550557711,597052213,809639268,334479406,1147609924
India,2006,559099816,606386475,818387902,343589817,1165486291
India,2007,567579951,615629520,826881860,352799379,1183209471
India,2008,575948779,624720983,835058767,362088139,1200669762
India,2009,584142641,633583576,842864409,371405723,1217726217
India,2010,592116982,642164181,850236137,380744554,1234281163
India,2011,599851346,650436593,857153804,390082225,1250287939
India,2012,607359892,658420351,863513505,399552347,1265780243
India,2013,614676458,666165661,869387533,409174674,1280842119
India,2014,621852998,673747770,874857621,419001673,1295600768
India,2015,628929060,681223332,879984521,429069459,1310152392
India,2016,635912563,688604687,884779655,439391699,1324517250
India,2017,642796257,695880522,889216746,449963381,1338676779
India,2018,649586703,703055580,893272090,460779764,1352642283
Indonesia,2000,105659995,105853827,122688942,88851487,211513822
Indonesia,2001,107066152,107361267,122734809,91771693,214427419
Indonesia,2002,108470613,108887177,122744187,94763872,217357790
Indonesia,2003,109875997,110433476,122719089,97826125,220309473
Indonesia,2004,111283965,112001701,122654979,100959670,223285666
Indonesia,2005,112697081,113592387,122557076,104155654,226289468
Indonesia,2006,114113394,115204868,122417389,107420813,229318262
Indonesia,2007,115537042,116837197,122237436,110751705,232374239
Indonesia,2008,116983222,118486533,122011566,114147710,235469755
Indonesia,2009,118471487,120149067,121743839,117596639,238620554
Indonesia,2010,120013721,121820505,121471143,121052980,241834226
Indonesia,2011,121616719,123499269,121392687,124314824,245115988
Indonesia,2012,123270656,125181058,121265363,127617869,248451714
Indonesia,2013,124949892,126855422,121087842,130944421,251805314
Indonesia,2014,126618711,128509365,120843234,134287882,255128076
Indonesia,2015,128250415,130132842,120527352,137634761,258383257
Indonesia,2016,129835522,131720864,120142531,140972925,261556386
Indonesia,2017,131378182,133272786,119696518,144294861,264650968
Indonesia,2018,132882052,134788497,119191974,147603006,267670549
Iran (Islamic Republic of),2000,32235845,33387552,23779764,42352090,65623397
Iran (Islamic Republic of),2001,32635113,33813998,23646162,43450252,66449111
Iran (Islamic Republic of),2002,33032451,34252349,23475745,44507585,67284800
Iran (Islamic Republic of),2003,33433618,34689329,23277974,45534739,68122947
Iran (Islamic Republic of),2004,33845529,35105750,23064517,46552583,68951279
Iran (Islamic Republic of),2005,34272736,35489609,22846437,47575374,69762345
Iran (Islamic Republic of),2006,34720281,35834475,22622393,48605487,70554756
Iran (Islamic Republic of),2007,35186535,36149941,22427746,49603357,71336476
Iran (Islamic Republic of),2008,35661229,36459379,22248124,50597418,72120608
Iran (Islamic Republic of),2009,36129675,36795158,22072992,51614573,72924833
Iran (Islamic Republic of),2010,36582329,37180190,21903373,52664138,73762519
Iran (Islamic Republic of),2011,37012837,37622122,21741243,53750339,74634959
Iran (Islamic Republic of),2012,37427003,38112878,21594353,54859221,75539881
Iran (Islamic Republic of),2013,37841907,38640056,21453348,55982036,76481963
Iran (Islamic Republic of),2014,38281566,39184203,21304537,57106555,77465769
Iran (Islamic Republic of),2015,38762065,39730143,21143455,58217032,78492208
Iran (Islamic Republic of),2016,39289457,40274534,20968583,59308845,79563991
Iran (Islamic Republic of),2017,39854902,40818986,20782600,60380188,80673888
Iran (Islamic Republic of),2018,40441309,41358895,20586680,61425055,81800204
Iraq,2000,11645105,11852484,7423961,16141452,23497589
Iraq,2001,11993807,12214371,7627084,16624564,24208178
Iraq,2002,12348005,12583917,7829905,17109394,24931922
Iraq,2003,12696366,12948137,8032210,17595416,25644503
Iraq,2004,13023971,13289867,8233973,18082636,26313838
Iraq,2005,13322742,13599537,8435932,18572494,26922279
Iraq,2006,13582225,13865899,8636414,19061498,27448124
Iraq,2007,13811949,14099293,8837116,19553317,27911242
Iraq,2008,14047922,14337817,9045912,20065505,28385739
Iraq,2009,14339392,14633765,9273303,20621349,28973157
Iraq,2010,14719558,15022419,9504630,21258071,29741977
Iraq,2011,15204594,15520711,9750420,21976633,30725305
Iraq,2012,15778329,16111683,10019158,22757413,31890012
Iraq,2013,16401828,16755233,10302117,23581028,33157061
Iraq,2014,17018736,17393213,10586506,24419574,34411949
Iraq,2015,17588528,17983741,10863394,25252255,35572269
Iraq,2016,18097667,18512965,11125775,26076797,36610632
Iraq,2017,18558853,18993936,11375936,26898682,37552789
Iraq,2018,18989537,19444067,11615946,27723807,38433604
Ireland,2000,1902624,1880471,1572038,2276738,3783095
Ireland,2001,1930547,1911706,1587218,2322075,3842253
Ireland,2002,1961303,1946692,1604488,2371800,3907995
Ireland,2003,1995223,1984854,1622840,2426707,3980077
Ireland,2004,2032769,2025362,1643163,2485586,4058131
Ireland,2005,2073902,2067315,1665092,2547885,4141217
Ireland,2006,2119424,2111195,1689583,2613787,4230619
Ireland,2007,2168305,2156344,1717899,2680174,4324649
Ireland,2008,2216519,2199352,1744599,2744990,4415871
Ireland,2009,2258745,2235827,1765932,2802132,4494572
Ireland,2010,2291388,2262942,1779414,2847514,4554330
Ireland,2011,2312402,2278713,1783796,2878783,4591115
Ireland,2012,2323451,2284748,1780388,2897729,4608199
Ireland,2013,2329210,2286216,1772537,2909430,4615426
Ireland,2014,2336426,2290426,1764876,2921471,4626852
Ireland,2015,2349876,2302544,1760732,2939375,4652420
Ireland,2016,2371266,2324524,1761090,2964988,4695790
Ireland,2017,2398834,2354447,1764335,2997322,4753281
Ireland,2018,2429851,2388843,1769220,3034528,4818694
Israel,2000,3016123,2929826,529030,5484711,5945949
Israel,2001,3074136,2986543,535306,5594224,6060679
Israel,2002,3128668,3040643,540933,5698352,6169311
Israel,2003,3183185,3095189,546487,5803032,6278374
Israel,2004,3242234,3154277,552700,5916127,6396511
Israel,2005,3308835,3220635,560059,6042911,6529470
Israel,2006,3384810,3295831,568798,6186413,6680641
Israel,2007,3468652,3378496,578650,6344035,6847148
Israel,2008,3556010,3464822,588921,6508489,7020832
Israel,2009,3640662,3549375,598671,6669224,7190037
Israel,2010,3718198,3628248,606998,6818961,7346446
Israel,2011,3787022,3700073,613695,6955079,7487095
Israel,2012,3848755,3766191,619009,7080096,7614946
Israel,2013,3906014,3828820,623292,7197813,7734834
Israel,2014,3962842,3891374,627075,7314254,7854216
Israel,2015,4022162,3956334,630733,7433814,7978496
Israel,2016,4084704,4024280,634341,7557487,8108984
Israel,2017,4149506,4094342,637763,7683807,8243848
Israel,2018,4215741,4165765,640922,7811919,8381506
Italy,2000,29257564,27434614,18779731,38513990,56692178
Italy,2001,29340860,27534288,18815119,38691248,56875148
Italy,2002,29476130,27706391,18853502,38948261,57182521
Italy,2003,29645367,27919222,18897042,39249995,57564589
Italy,2004,29821759,28126662,18940573,39554131,57948421
Italy,2005,29985474,28295735,18972670,39835813,58281209
Italy,2006,30129215,28413404,18990436,40089433,58542619
Italy,2007,30257431,28490431,18995609,40317902,58747862
Italy,2008,30375911,28546205,18985986,40516399,58922116
Italy,2009,30494884,28610738,18960542,40681311,59105622
Italy,2010,30620695,28704537,18918497,40811310,59325232
Italy,2011,30755241,28833829,18858134,40901795,59589070
Italy,2012,30892031,28987438,18706111,41027723,59879469
Italy,2013,31019089,29147739,18509653,41158347,60166828
Italy,2014,31120275,29289347,18309186,41276482,60409622
Italy,2015,31184366,29394123,18110394,41393818,60578489
Italy,2016,31206813,29456255,17914936,41515002,60663068
Italy,2017,31191894,29481800,17722588,41637312,60673694
Italy,2018,31148283,29479008,17527870,41763099,60627291
Jamaica,2000,1334328,1320370,1280230,1376634,2654698
Jamaica,2001,1344878,1329828,1283535,1393476,2674706
Jamaica,2002,1355253,1337590,1287060,1408386,2692843
Jamaica,2003,1365193,1344245,1290139,1422372,2709438
Jamaica,2004,1374337,1350680,1292771,1436006,2725017
Jamaica,2005,1382458,1357542,1295184,1449489,2740000
Jamaica,2006,1389410,1365004,1297396,1462883,2754414
Jamaica,2007,1395341,1372888,1299356,1476111,2768229
Jamaica,2008,1400790,1381079,1301007,1489115,2781869
Jamaica,2009,1406493,1389346,1302297,1501785,2795839
Jamaica,2010,1412952,1397512,1303146,1514064,2810464
Jamaica,2011,1420363,1405569,1303559,1525934,2825932
Jamaica,2012,1428546,1413582,1303108,1537884,2842128
Jamaica,2013,1437226,1421484,1301853,1549954,2858710
Jamaica,2014,1445931,1429206,1299857,1562230,2875137
Jamaica,2015,1454324,1436700,1297166,1574768,2891024
Jamaica,2016,1462325,1443917,1293787,1587568,2906242
Jamaica,2017,1470007,1450841,1289697,1600602,2920848
Jamaica,2018,1477400,1457453,1284862,1613815,2934853
Japan,2000,64899596,62624572,27230218,100303716,127524168
Japan,2001,65023636,62690188,25557575,102165938,127713824
Japan,2002,65141751,62751324,23473865,104428752,127893075
Japan,2003,65252239,62806129,21520729,106547065,128058368
Japan,2004,65352535,62851648,19693113,108520519,128204183
Japan,2005,65440529,62885586,17995058,110340709,128326115
Japan,2006,65515518,62907222,16545175,111887819,128422740
Japan,2007,65577155,62916895,15233582,113271669,128494050
Japan,2008,65624069,62914575,14008192,114542316,128538644
Japan,2009,65654723,62900473,12870195,115696464,128555196
Japan,2010,65667840,62874509,11810839,116741034,128542349
Japan,2011,65662632,62836334,11476384,117029015,128498966
Japan,2012,65638573,62784997,11368012,117058372,128423570
Japan,2013,65595132,62719057,11257825,117055095,128314189
Japan,2014,65531848,62636782,11145296,117017577,128168630
Japan,2015,65448394,62536745,11030530,116944428,127985139
Japan,2016,65344649,62418618,10913416,116835097,127763267
Japan,2017,65220509,62282219,10791174,116693276,127502728
Japan,2018,65075698,62126492,10663807,116521525,127202190
Jordan,2000,2467365,2655130,1108890,3994240,5122495
Jordan,2001,2515778,2701550,1127867,4065615,5217328
Jordan,2002,2565875,2751639,1147614,4139874,5317514
Jordan,2003,2623759,2810277,1170651,4226123,5434036
Jordan,2004,2697018,2883223,1200064,4335531,5580241
Jordan,2005,2791043,2974596,1172277,4541834,5765639
Jordan,2006,2906651,3084896,1129312,4804920,5991547
Jordan,2007,3042189,3213101,1091804,5101387,6255290
Jordan,2008,3197087,3359386,1058386,5431436,6556473
Jordan,2009,3369863,3523395,1028066,5793050,6893258
Jordan,2010,3558032,3703509,999206,6183184,7261541
Jordan,2011,3762256,3900602,971693,6603250,7662858
Jordan,2012,3978958,4111005,944332,7048241,8089963
Jordan,2013,4196092,4322900,914962,7498502,8518992
Jordan,2014,4397998,4520824,880931,7928375,8918822
Jordan,2015,4573163,4693410,892500,8266802,9266573
Jordan,2016,4717553,4836733,897724,8558078,9554286
Jordan,2017,4833068,4952772,897788,8804565,9785840
Jordan,2018,4921841,5043481,893429,9010373,9965322
Kazakhstan,2000,7745522,7177202,6610426,8446937,14922724
Kazakhstan,2001,7742240,7167967,6591821,8448150,14910207
Kazakhstan,2002,7775882,7200302,6609578,8496067,14976184
Kazakhstan,2003,7836654,7263391,6653891,8578434,15100045
Kazakhstan,2004,7909533,7340483,6709744,8676172,15250016
Kazakhstan,2005,7983544,7419259,6766257,8775200,15402803
Kazakhstan,2006,8055147,7496116,6819865,8870996,15551263
Kazakhstan,2007,8127611,7574501,6873733,8967622,15702112
Kazakhstan,2008,8204799,7657327,6931410,9069766,15862126
Kazakhstan,2009,8293145,7749870,6998909,9185254,16043015
Kazakhstan,2010,8396755,7855518,7079870,9319106,16252273
Kazakhstan,2011,8516310,7974359,7175002,9472378,16490669
Kazakhstan,2012,8648331,8103192,7280687,9640492,16751523
Kazakhstan,2013,8787867,8238251,7391287,9815970,17026118
Kazakhstan,2014,8928168,8374450,7499077,9988702,17302618
Kazakhstan,2015,9064122,8507888,7598480,10151168,17572010
Kazakhstan,2016,9193835,8637067,7687326,10300410,17830902
Kazakhstan,2017,9317881,8762142,7766771,10437728,18080023
Kazakhstan,2018,9436706,8882910,7834880,10568980,18319616
Kenya,2000,16097751,15866806,25194298,6256185,31964557
Kenya,2001,16546530,16302038,25779834,6541648,32848568
Kenya,2002,17004033,16747713,26374762,6839247,33751746
Kenya,2003,17472554,17206227,26981085,7149767,34678781
Kenya,2004,17954877,17680390,27600542,7474389,35635267
Kenya,2005,18452871,18172026,28234834,7813454,36624897
Kenya,2006,18967160,18681879,28883861,8168189,37649039
Kenya,2007,19496920,19209014,29547088,8538821,38705934
Kenya,2008,20040720,19751264,30222715,8925701,39791984
Kenya,2009,20596355,20305443,30909074,9328130,40901798
Kenya,2010,21161842,20868842,31603483,9746669,42030684
Kenya,2011,21737158,21441112,32303238,10183601,43178270
Kenya,2012,22321708,22021761,33007199,10639429,44343469
Kenya,2013,22912189,22607797,33712691,11114158,45519986
Kenya,2014,23504483,23195580,34416636,11607614,46700063
Kenya,2015,24095730,23782609,35116503,12119756,47878339
Kenya,2016,24684280,24367251,35810733,12650834,49051531
Kenya,2017,25271004,24950142,36498515,13201347,50221146
Kenya,2018,25858696,25533874,37179074,13771805,51392570
Kiribati,2000,42813,41592,48147,36259,84405
Kiribati,2001,43558,42286,48533,37325,85844
Kiribati,2002,44308,43000,49355,37988,87308
Kiribati,2003,45078,43762,50215,38680,88840
Kiribati,2004,45913,44585,51127,39415,90498
Kiribati,2005,46836,45483,52116,40209,92319
Kiribati,2006,47868,46473,52757,41503,94341
Kiribati,2007,48986,47545,53100,43211,96531
Kiribati,2008,50127,48633,53447,44993,98760
Kiribati,2009,51246,49682,53757,46811,100928
Kiribati,2010,52280,50650,54005,48647,102930
Kiribati,2011,53218,51517,54175,50481,104735
Kiribati,2012,54067,52292,54285,52328,106359
Kiribati,2013,54867,53020,54347,54188,107887
Kiribati,2014,55647,53740,54375,56083,109387
Kiribati,2015,56436,54491,54383,58024,110927
Kiribati,2016,57251,55278,54395,60000,112529
Kiribati,2017,58066,56087,54402,61996,114153
Kiribati,2018,58904,56938,54403,64010,115842
Kuwait,2000,849821,1195302,20507,2030234,2045123
Kuwait,2001,870671,1232602,1938,2107417,2103273
Kuwait,2002,880148,1256843,0,2143833,2136991
Kuwait,2003,885993,1275633,0,2169118,2161626
Kuwait,2004,899809,1300689,0,2207939,2200498
Kuwait,2005,929721,1340475,0,2276623,2270196
Kuwait,2006,977434,1396227,0,2377258,2373661
Kuwait,2007,1039223,1464802,0,2503410,2504025
Kuwait,2008,1111105,1544905,0,2652340,2656010
Kuwait,2009,1186992,1634049,0,2818939,2821041
Kuwait,2010,1262012,1729872,0,2998083,2991884
Kuwait,2011,1335807,1832247,0,3191051,3168054
Kuwait,2012,1408485,1940367,0,3395556,3348852
Kuwait,2013,1476160,2050222,0,3598385,3526382
Kuwait,2014,1534201,2156738,0,3782450,3690939
Kuwait,2015,1579599,2255989,0,3935794,3835588
Kuwait,2016,1610201,2346661,0,4052584,3956862
Kuwait,2017,1627387,2428715,0,4136528,4056102
Kuwait,2018,1636232,2501082,0,4197128,4137314
Kyrgyzstan,2000,2487725,2432987,3183803,1736915,4920712
Kyrgyzstan,2001,2507549,2455290,3210973,1751617,4962839
Kyrgyzstan,2002,2520265,2471213,3229231,1761456,4991478
Kyrgyzstan,2003,2529715,2483823,3243275,1768994,5013538
Kyrgyzstan,2004,2541459,2497536,3259958,1777971,5038995
Kyrgyzstan,2005,2559608,2515732,3284272,1791108,5075340
Kyrgyzstan,2006,2585243,2539136,3317581,1809149,5124379
Kyrgyzstan,2007,2617305,2567079,3358424,1831296,5184384
Kyrgyzstan,2008,2655102,2599867,3405472,1856822,5254969
Kyrgyzstan,2009,2697256,2637452,3456349,1884432,5334708
Kyrgyzstan,2010,2742619,2679679,3507918,1914419,5422298
Kyrgyzstan,2011,2791099,2726828,3559886,1946715,5517927
Kyrgyzstan,2012,2842867,2778716,3612530,1981578,5621583
Kyrgyzstan,2013,2897252,2834060,3665102,2018706,5731312
Kyrgyzstan,2014,2953410,2891111,3716797,2057768,5844521
Kyrgyzstan,2015,3010634,2948492,3766909,2098492,5959126
Kyrgyzstan,2016,3068610,3005717,3814995,2140739,6074327
Kyrgyzstan,2017,3127027,3062700,3860700,2184417,6189727
Kyrgyzstan,2018,3185100,3118925,3903563,2229369,6304025
Lao People's Democratic Republic,2000,2673778,2649923,4158068,1171236,5323701
Lao People's Democratic Republic,2001,2719911,2689673,4169569,1244999,5409584
Lao People's Democratic Republic,2002,2765743,2727504,4175524,1321748,5493247
Lao People's Democratic Republic,2003,2811705,2764935,4177698,1401957,5576640
Lao People's Democratic Republic,2004,2858273,2803926,4178087,1486517,5662199
Lao People's Democratic Republic,2005,2905736,2845939,4189729,1564297,5751675
Lao People's Democratic Republic,2006,2954578,2891497,4226291,1623065,5846075
Lao People's Democratic Republic,2007,3004654,2940296,4265018,1684769,5944950
Lao People's Democratic Republic,2008,3054823,2991807,4303532,1748658,6046630
Lao People's Democratic Republic,2009,3103528,3045093,4338737,1813299,6148621
Lao People's Democratic Republic,2010,3149737,3099431,4368384,1877890,6249168
Lao People's Democratic Republic,2011,3192854,3154710,4391626,1941861,6347564
Lao People's Democratic Republic,2012,3233528,3210999,4409554,2005615,6444527
Lao People's Democratic Republic,2013,3273473,3267829,4424627,2069929,6541302
Lao People's Democratic Republic,2014,3315124,3324639,4439922,2136475,6639763
Lao People's Democratic Republic,2015,3360147,3381013,4457637,2206330,6741160
Lao People's Democratic Republic,2016,3409178,3436670,4478363,2279990,6845848
Lao People's Democratic Republic,2017,3461499,3491532,4501174,2356986,6953031
Lao People's Democratic Republic,2018,3515875,3545623,4524499,2436711,7061498
Latvia,2000,1288580,1095570,761342,1622821,2384150
Latvia,2001,1275234,1083455,755946,1602731,2358689
Latvia,2002,1261579,1070949,749886,1582606,2332528
Latvia,2003,1247685,1058160,742460,1563315,2305845
Latvia,2004,1233635,1045287,731523,1547332,2278922
Latvia,2005,1219497,1032499,720635,1531348,2251996
Latvia,2006,1205278,1019785,712806,1512417,2225063
Latvia,2007,1190980,1007109,705716,1492802,2198089
Latvia,2008,1176689,994559,698617,1473264,2171248
Latvia,2009,1162532,982252,690494,1454815,2144784
Latvia,2010,1148590,970265,681390,1437458,2118855
Latvia,2011,1134956,958650,672334,1420159,2093606
Latvia,2012,1121607,947411,663369,1403005,2069018
Latvia,2013,1108431,936519,654589,1386195,2044950
Latvia,2014,1095245,925975,646121,1370004,2021220
Latvia,2015,1081948,915727,638051,1354612,1997675
Latvia,2016,1068471,905794,630159,1340371,1974265
Latvia,2017,1054916,896181,622436,1327234,1951097
Latvia,2018,1041565,886896,614843,1315095,1928461
Lebanon,2000,1928063,1914711,452951,2782415,3842774
Lebanon,2001,1994505,1996494,466411,2893448,3990999
Lebanon,2002,2079580,2102625,484740,3038097,4182205
Lebanon,2003,2170966,2217412,504674,3196790,4388378
Lebanon,2004,2251005,2318372,521754,3341513,4569377
Lebanon,2005,2308205,2390556,533172,3453680,4698761
Lebanon,2006,2334707,2425053,537103,3520247,4759760
Lebanon,2007,2337468,2429879,535295,3551171,4767347
Lebanon,2008,2337491,2427254,532696,3578351,4764745
Lebanon,2009,2364264,2448762,536000,3647156,4813026
Lebanon,2010,2437390,2515674,549350,3787791,4953064
Lebanon,2011,2565380,2636642,574302,4014066,5202022
Lebanon,2012,2737182,2800438,607879,4308525,5537620
Lebanon,2013,2928916,2984100,644202,4631900,5913016
Lebanon,2014,3106446,3154600,675369,4927910,6261046
Lebanon,2015,3244861,3287820,695996,5155483,6532681
Lebanon,2016,3337135,3377146,704804,5301864,6714281
Lebanon,2017,3390062,3429311,703805,5378552,6819373
Lebanon,2018,3409524,3449884,695098,5398411,6859408
Lesotho,2000,1056121,976684,1503411,365288,2032805
Lesotho,2001,1058415,977323,1507504,378451,2035738
Lesotho,2002,1054653,975179,1510496,391816,2029832
Lesotho,2003,1046986,971369,1512665,405432,2018355
Lesotho,2004,1038607,967346,1514330,419398,2005953
Lesotho,2005,1031911,964204,1515794,433749,1996115
Lesotho,2006,1027539,962394,1517098,448564,1989933
Lesotho,2007,1024996,961930,1520337,461950,1986926
Lesotho,2008,1024133,962997,1524036,475894,1987130
Lesotho,2009,1024479,965656,1528685,490524,1990135
Lesotho,2010,1025674,969901,1534536,506015,1995575
Lesotho,2011,1027842,975951,1541726,522440,2003793
Lesotho,2012,1031205,983782,1552732,537196,2014987
Lesotho,2013,1035656,992872,1564710,552651,2028528
Lesotho,2014,1041000,1002448,1577102,568683,2043448
Lesotho,2015,1047082,1011929,1589499,585146,2059011
Lesotho,2016,1053896,1021145,1601793,602028,2075041
Lesotho,2017,1061370,1030162,1614034,619305,2091532
Lesotho,2018,1069278,1039049,1625909,637101,2108327
Liberia,2000,1428378,1420069,1605791,1278731,2848447
Liberia,2001,1480428,1473500,1654891,1336241,2953928
Liberia,2002,1514992,1509735,1684052,1378811,3024727
Liberia,2003,1540238,1536817,1702673,1413560,3077055
Liberia,2004,1568658,1566996,1724596,1451818,3135654
Liberia,2005,1609120,1608994,1759411,1501819,3218114
Liberia,2006,1664043,1665168,1809583,1566255,3329211
Liberia,2007,1729872,1732039,1870927,1642005,3461911
Liberia,2008,1802372,1805491,1938155,1724838,3607863
Liberia,2009,1874988,1879141,2003149,1808379,3754129
Liberia,2010,1942962,1948395,2060391,1887733,3891357
Liberia,2011,2005232,2012214,2108635,1961532,4017446
Liberia,2012,2063458,2072203,2150015,2031548,4135661
Liberia,2013,2118813,2129524,2186655,2099636,4248337
Liberia,2014,2173342,2186166,2221838,2168899,4359508
Liberia,2015,2228589,2243640,2257906,2241715,4472229
Liberia,2016,2284705,2302083,2295213,2318610,4586788
Liberia,2017,2341202,2361022,2332953,2398953,4702224
Liberia,2018,2398322,2420654,2370874,2482642,4818976
Libya,2000,2576914,2780979,1264648,4091103,5357893
Libya,2001,2621982,2821267,1278407,4162158,5443249
Libya,2002,2667872,2863225,1291813,4235702,5531097
Libya,2003,2714484,2906061,1304684,4311268,5620545
Libya,2004,2761608,2948555,1316735,4388024,5710163
Libya,2005,2808935,2989680,1327659,4465029,5798615
Libya,2006,2857017,3029857,1337827,4543608,5886874
Libya,2007,2905616,3069170,1347074,4623288,5974786
Libya,2008,2952780,3105960,1353957,4699121,6058740
Libya,2009,2995928,3138059,1356609,4764444,6133987
Libya,2010,3033419,3164248,1353986,4815154,6197667
Libya,2011,3064110,3183328,1345388,4848113,6247438
Libya,2012,3089182,3196569,1331872,4866386,6285751
Libya,2013,3112114,3208236,1316263,4879707,6320350
Libya,2014,3137853,3224186,1302302,4901806,6362039
Libya,2015,3169825,3248490,1292476,4942479,6418315
Libya,2016,3209343,3282817,1287595,5005658,6492160
Libya,2017,3255123,3325600,1286565,5088051,6580723
Libya,2018,3304807,3373758,1287593,5183363,6678565
Lithuania,2000,1862857,1638985,1156103,2345732,3501842
Lithuania,2001,1850149,1623474,1149120,2324497,3473623
Lithuania,2002,1837028,1607749,1142699,2302055,3444777
Lithuania,2003,1823077,1591290,1135717,2278635,3414367
Lithuania,2004,1807752,1573382,1127745,2253373,3381134
Lithuania,2005,1790686,1553573,1115801,2228451,3344259
Lithuania,2006,1771709,1531620,1099915,2203756,3303329
Lithuania,2007,1751057,1507927,1083093,2176998,3258984
Lithuania,2008,1729330,1483537,1065707,2148920,3212867
Lithuania,2009,1707396,1459874,1050712,2118060,3167270
Lithuania,2010,1685871,1437954,1038457,2085346,3123825
Lithuania,2011,1665147,1418255,1024337,2055543,3083402
Lithuania,2012,1645075,1400486,1006428,2030818,3045561
Lithuania,2013,1625033,1383905,989541,2007793,3008938
Lithuania,2014,1604112,1367386,974207,1987639,2971498
Lithuania,2015,1581735,1350137,960792,1971134,2931872
Lithuania,2016,1557606,1331949,949079,1959170,2889555
Lithuania,2017,1532240,1313179,938898,1951399,2845419
Lithuania,2018,1506858,1294412,929713,1946762,2801270
Luxembourg,2000,221319,214787,68834,367269,436106
Luxembourg,2001,223319,216878,66722,373476,440197
Luxembourg,2002,225060,218667,65233,378492,443727
Luxembourg,2003,226822,220495,63775,383547,447317
Luxembourg,2004,229015,222807,62457,389362,451822
Luxembourg,2005,231913,225935,61360,396482,457848
Luxembourg,2006,235639,229972,60480,405074,465611
Luxembourg,2007,240087,234830,59770,414952,474917
Luxembourg,2008,245072,240331,59185,425920,485403
Luxembourg,2009,250312,246224,58668,437611,496536
Luxembourg,2010,255593,252297,58167,449722,507890
Luxembourg,2011,260845,258466,57681,462260,519311
Luxembourg,2012,266099,264756,57239,475148,530855
Luxembourg,2013,271385,271169,56792,487929,542554
Luxembourg,2014,276778,277734,56277,500039,554512
Luxembourg,2015,282300,284441,55660,511081,566741
Luxembourg,2016,287974,291292,54927,520820,579266
Luxembourg,2017,293717,298197,54103,529352,591914
Luxembourg,2018,299338,304906,53239,537082,604244
Madagascar,2000,7916321,7850485,11490635,4276171,15766806
Madagascar,2001,8164825,8096108,11806896,4454036,16260933
Madagascar,2002,8418066,8347056,12127427,4637690,16765122
Madagascar,2003,8675989,8603150,12452023,4827118,17279139
Madagascar,2004,8938678,8864314,12780505,5022492,17802992
Madagascar,2005,9206229,9130493,13053181,5283543,18336722
Madagascar,2006,9478638,9401627,13324762,5555506,18880265
Madagascar,2007,9755836,9677684,13595040,5838483,19433520
Madagascar,2008,10037735,9958741,13863552,6132917,19996476
Madagascar,2009,10324223,10244892,14130850,6438271,20569115
Madagascar,2010,10615345,10536295,14396303,6755337,21151640
Madagascar,2011,10911027,10832943,14659814,7084135,21743970
Madagascar,2012,11211590,11135051,14921525,7425048,22346641
Madagascar,2013,11517928,11443331,15182304,7778842,22961259
Madagascar,2014,11831212,11758685,15443315,8146486,23589897
Madagascar,2015,12152289,12081791,15705295,8528793,24234080
Madagascar,2016,12481481,12412889,15968305,8926246,24894370
Madagascar,2017,12818661,12751850,16231870,9339025,25570511
Madagascar,2018,13163713,13098600,16495525,9767285,26262313
Malawi,2000,5645174,5503577,9714122,1662050,11148751
Malawi,2001,5793193,5638808,9976835,1719028,11432001
Malawi,2002,5939948,5773715,10237350,1776361,11713663
Malawi,2003,6088662,5911521,10501614,1835073,12000183
Malawi,2004,6244565,6057272,10779157,1896881,12301837
Malawi,2005,6411359,6214591,11076729,1962982,12625950
Malawi,2006,6589614,6384079,11395534,2033728,12973693
Malawi,2007,6777615,6564193,11732355,2108614,13341808
Malawi,2008,6974134,6753765,12084063,2187171,13727899
Malawi,2009,7177240,6950921,12444330,2270272,14128161
Malawi,2010,7385419,7154190,12809514,2357581,14539609
Malawi,2011,7598612,7363506,13178480,2449138,14962118
Malawi,2012,7817021,7578989,13551942,2545363,15396010
Malawi,2013,8039829,7799458,13930476,2646671,15839287
Malawi,2014,8266066,8023484,14315223,2753615,16289550
Malawi,2015,8495171,8250134,14706907,2866700,16745305
Malawi,2016,8726571,8478682,15105299,2986276,17205253
Malawi,2017,8960635,8709558,15509514,3112590,17670193
Malawi,2018,9198885,8944330,15918795,3245933,18143215
Malaysia,2000,11376247,11818005,8815954,14369654,23194252
Malaysia,2001,11618585,12090530,8787057,14911850,23709115
Malaysia,2002,11850200,12358191,8746392,15452419,24208391
Malaysia,2003,12074668,12624153,8695421,15993282,24698821
Malaysia,2004,12297492,12893155,8636297,16537812,25190647
Malaysia,2005,12522563,13168052,8571839,17087554,25690615
Malaysia,2006,12751205,13450749,8501085,17642481,26201954
Malaysia,2007,12981865,13738502,8424428,18201417,26720367
Malaysia,2008,13212119,14023884,8343387,18767682,27236003
Malaysia,2009,13438288,14296750,8260981,19344402,27735038
Malaysia,2010,13657901,14550127,8177340,19934949,28208028
Malaysia,2011,13870044,14780918,8129924,20505204,28650962
Malaysia,2012,14076071,14992118,8087429,21083027,29068189
Malaysia,2013,14278481,15190442,8041475,21665249,29468923
Malaysia,2014,14480879,15385727,7987242,22240775,29866606
Malaysia,2015,14685798,15585167,7922592,22800563,30270965
Malaysia,2016,14893934,15790718,7846716,23340549,30684652
Malaysia,2017,15104343,16000312,7764814,23859450,31104655
Malaysia,2018,15315852,16212181,7678728,24363730,31528033
Maldives,2000,138056,141340,202701,77683,279396
Maldives,2001,140796,145513,204194,82833,286309
Maldives,2002,143696,150489,205915,88426,294185
Maldives,2003,146701,155980,207762,94447,302681
Maldives,2004,149712,161553,209566,100857,311265
Maldives,2005,152656,166948,211230,107606,319604
Maldives,2006,155510,171979,213467,113904,327489
Maldives,2007,158300,176872,217772,118298,335172
Maldives,2008,161102,182346,222180,122874,343448
Maldives,2009,163989,189402,226807,127694,353391
Maldives,2010,167029,198701,231706,132805,365730
Maldives,2011,170246,210247,236899,138232,380493
Maldives,2012,173599,223632,242277,143926,397231
Maldives,2013,177005,238587,247637,149760,415592
Maldives,2014,180346,254672,252679,155568,435018
Maldives,2015,183547,271367,257196,161207,454914
Maldives,2016,186567,288938,261129,166627,475505
Maldives,2017,189425,306973,264503,171827,496398
Maldives,2018,192177,323527,267408,176851,515704
Mali,2000,5518018,5428430,7857672,3110018,10946448
Mali,2001,5678221,5593382,8009704,3283554,11271603
Mali,2002,5848244,5768646,8169810,3469119,11616890
Mali,2003,6028197,5954495,8337868,3667260,11982692
Mali,2004,6218014,6151064,8513241,3878665,12369078
Mali,2005,6417394,6358115,8695429,4103334,12775509
Mali,2006,6626930,6576448,8884418,4342646,13203378
Mali,2007,6846126,6805329,9078960,4596646,13651455
Mali,2008,7072303,7041275,9274295,4863921,14113578
Mali,2009,7301855,7279572,9465102,5141495,14581427
Mali,2010,7532329,7517023,9648158,5426927,15049352
Mali,2011,7762521,7752072,9822006,5718983,15514593
Mali,2012,7993442,7986050,9988283,6018387,15979492
Mali,2013,8227526,8222327,10150619,6327199,16449853
Mali,2014,8468385,8465828,10314127,6648719,16934213
Mali,2015,8718647,8720125,10482312,6985593,17438772
Mali,2016,8979115,8986333,10655945,7338892,17965448
Mali,2017,9249030,9263399,10833712,7708268,18512429
Mali,2018,9527621,9550134,11014386,8093320,19077755
Malta,2000,198385,195264,30274,366394,393649
Malta,2001,199675,196649,29376,369779,396324
Malta,2002,200873,197847,28474,372829,398720
Malta,2003,201977,198881,27580,375631,400858
Malta,2004,203007,199813,26703,378304,402820
Malta,2005,203969,200690,25851,380936,404659
Malta,2006,204846,201484,25398,383165,406330
Malta,2007,205653,202201,25207,385117,407854
Malta,2008,206484,203009,25019,387109,409493
Malta,2009,207451,204108,24840,389205,411559
Malta,2010,208649,205608,24669,391441,414257
Malta,2011,210113,207607,24510,393857,417720
Malta,2012,211790,210019,24360,396429,421809
Malta,2013,213550,212594,24213,399033,426144
Malta,2014,215197,214993,24058,401512,430190
Malta,2015,216588,216971,23888,403728,433559
Malta,2016,217660,218439,23701,405661,436099
Malta,2017,218470,219465,23498,407337,437935
Malta,2018,219071,220184,23280,408809,439255
Mauritania,2000,1322342,1307875,1677325,1032034,2630217
Mauritania,2001,1357736,1344669,1713052,1077677,2702405
Mauritania,2002,1394948,1383149,1738864,1134364,2778097
Mauritania,2003,1433873,1423277,1763883,1193234,2857150
Mauritania,2004,1474310,1464936,1788286,1254537,2939246
Mauritania,2005,1516122,1508076,1812352,1318368,3024198
Mauritania,2006,1559259,1552649,1835828,1384825,3111908
Mauritania,2007,1603818,1598694,1858724,1453941,3202512
Mauritania,2008,1649899,1646338,1881382,1526159,3296237
Mauritania,2009,1697684,1695724,1904408,1601880,3393408
Mauritania,2010,1747258,1746942,1927922,1681621,3494200
Mauritania,2011,1798640,1800006,1952048,1765624,3598646
Mauritania,2012,1851740,1854815,1976397,1853842,3706555
Mauritania,2013,1906310,1911187,2000466,1945704,3817497
Mauritania,2014,1962065,1968829,2023713,2040207,3930894
Mauritania,2015,2018756,2027548,2045642,2136699,4046304
Mauritania,2016,2076282,2087250,2066106,2234912,4163532
Mauritania,2017,2134662,2147920,2085277,2334906,4282582
Mauritania,2018,2193847,2209465,2103324,2436744,4403312
Mauritius,2000,597454,587693,679440,505705,1185147
Mauritius,2001,602169,591742,685803,508114,1193911
Mauritius,2002,606283,595522,691683,510129,1201805
Mauritius,2003,609912,599080,697168,511826,1208992
Mauritius,2004,613237,602431,702381,513296,1215668
Mauritius,2005,616390,605620,707398,514605,1222010
Mauritius,2006,619427,608662,712296,515802,1228089
Mauritius,2007,622324,611566,717043,516868,1233890
Mauritius,2008,625010,614252,721553,517740,1239262
Mauritius,2009,627385,616611,725690,518333,1243996
Mauritius,2010,629375,618578,729371,518583,1247953
Mauritius,2011,630949,620125,732554,518469,1251074
Mauritius,2012,632192,621297,735323,518048,1253489
Mauritius,2013,633252,622206,737839,517451,1255458
Mauritius,2014,634355,622996,740367,516852,1257351
Mauritius,2015,635662,623795,743079,516376,1259457
Mauritius,2016,637242,624628,745793,516339,1261870
Mauritius,2017,639019,625478,748440,516698,1264497
Mauritius,2018,640905,626279,750928,517386,1267184
Mexico,2000,50341811,48558034,25712262,76007411,98899845
Mexico,2001,51089400,49208752,25720596,77346472,100298152
Mexico,2002,51842881,49841883,25708164,78647444,101684764
Mexico,2003,52605394,50475626,25689517,79950936,103081020
Mexico,2004,53379978,51134956,25682103,81313480,104514934
Mexico,2005,54168352,51836847,25698905,82773323,106005199
Mexico,2006,54971858,52588297,25744268,84348110,107560155
Mexico,2007,55789026,53381477,25812028,86024318,109170503
Mexico,2008,56615017,54200255,25890431,87771378,110815272
Mexico,2009,57442951,55020935,25966026,89539202,112463886
Mexico,2010,58267177,55825784,26026826,91292115,114092961
Mexico,2011,59086044,56609424,26068110,93021907,115695468
Mexico,2012,59898832,57375324,26092527,94735780,117274156
Mexico,2013,60701892,58125266,26100980,96434989,118827158
Mexico,2014,61491303,58863834,26095704,98125896,120355137
Mexico,2015,62264080,59594171,26078248,99812701,121858251
Mexico,2016,63018020,60315359,26048191,101492232,123333379
Mexico,2017,63752823,61024503,26004525,103158751,124777326
Mexico,2018,64469963,61720819,25947576,104811498,126190782
Micronesia (Federated States of),2000,53036,54369,83442,23990,107405
Micronesia (Federated States of),2001,52924,54246,83235,23930,107170
Micronesia (Federated States of),2002,52813,54214,83094,23889,107027
Micronesia (Federated States of),2003,52685,54217,82964,23852,106902
Micronesia (Federated States of),2004,52478,54146,82778,23799,106624
Micronesia (Federated States of),2005,52196,53939,82482,23714,106135
Micronesia (Federated States of),2006,51808,53566,82091,23593,105374
Micronesia (Federated States of),2007,51367,53075,81627,23451,104442
Micronesia (Federated States of),2008,50952,52597,81168,23310,103549
Micronesia (Federated States of),2009,50694,52277,80772,23188,102971
Micronesia (Federated States of),2010,50675,52241,80511,23105,102916
Micronesia (Federated States of),2011,50937,52511,80390,23078,103448
Micronesia (Federated States of),2012,51446,53060,80397,23106,104506
Micronesia (Federated States of),2013,52122,53800,80519,23183,105922
Micronesia (Federated States of),2014,52855,54589,80716,23299,107444
Micronesia (Federated States of),2015,53543,55343,80981,23452,108886
Micronesia (Federated States of),2016,54189,56026,81299,23638,110215
Micronesia (Federated States of),2017,54793,56668,81683,23861,111461
Micronesia (Federated States of),2018,55368,57272,82110,24117,112640
Mongolia,2000,1201814,1195603,1027711,1369725,2397417
Mongolia,2001,1212723,1206871,1010938,1408838,2419594
Mongolia,2002,1224994,1218267,994464,1449195,2443261
Mongolia,2003,1238626,1230139,978385,1490901,2468765
Mongolia,2004,1253482,1242912,962707,1534125,2496394
Mongolia,2005,1269509,1256920,947564,1578882,2526429
Mongolia,2006,1286645,1272209,932771,1625241,2558854
Mongolia,2007,1305021,1288798,918387,1673283,2593819
Mongolia,2008,1324955,1306944,904588,1723543,2631899
Mongolia,2009,1346849,1326945,891731,1776558,2673794
Mongolia,2010,1370942,1348960,879794,1832856,2719902
Mongolia,2011,1397297,1373060,884714,1876802,2770357
Mongolia,2012,1425659,1399039,899714,1914512,2824698
Mongolia,2013,1455446,1426337,915345,1953762,2881783
Mongolia,2014,1485885,1454226,930872,1993024,2940111
Mongolia,2015,1516358,1482075,945754,2031123,2998433
Mongolia,2016,1546658,1509700,959785,2067612,3056358
Mongolia,2017,1576728,1537060,973037,2102610,3113788
Mongolia,2018,1606333,1563881,985062,2136710,3170214
Montenegro,2006,313668,304195,229817,388015,617863
Montenegro,2007,314347,305207,228348,391136,619554
Montenegro,2008,314971,306341,226898,394307,621312
Montenegro,2009,315531,307402,225423,397429,622933
Montenegro,2010,316000,308279,223866,400419,624279
Montenegro,2011,316363,308908,222219,403247,625271
Montenegro,2012,316616,309315,220462,405924,625931
Montenegro,2013,316779,309563,218623,408471,626342
Montenegro,2014,316916,309734,216730,410944,626650
Montenegro,2015,317048,309909,214802,413376,626957
Montenegro,2016,317178,310093,212843,415772,627271
Montenegro,2017,317307,310256,210847,418113,627563
Montenegro,2018,317411,310392,208816,420403,627803
Morocco,2000,14524941,14268731,13462682,15386939,28793672
Morocco,2001,14702639,14423684,13522209,15659623,29126323
Morocco,2002,14877638,14577127,13578750,15933618,29454765
Morocco,2003,15052206,14730678,13633701,16210236,29782884
Morocco,2004,15229100,14886096,13688174,16491111,30115196
Morocco,2005,15410459,15045104,13681416,16839654,30455563
Morocco,2006,15597111,15207578,13660936,17208410,30804689
Morocco,2007,15789074,15374596,13640554,17585327,31163670
Morocco,2008,15986463,15550344,13622608,17974247,31536807
Morocco,2009,16189074,15740013,13610904,18378993,31929087
Morocco,2010,16396564,15946819,13606337,18803302,32343383
Morocco,2011,16609017,16172843,13609908,19248915,32781860
Morocco,2012,16826156,16415741,13619442,19714347,33241897
Morocco,2013,17046813,16668892,13631417,20193352,33715705
Morocco,2014,17269399,16922959,13639438,20678644,34192358
Morocco,2015,17492569,17171039,13639728,21163594,34663608
Morocco,2016,17715791,17410483,13630788,21645998,35126274
Morocco,2017,17938664,17642593,13613878,22125702,35581257
Morocco,2018,18160047,17869042,13589062,22602743,36029089
Mozambique,2000,9242786,8469139,12810292,5257395,17711925
Mozambique,2001,9500555,8721329,13146513,5442245,18221884
Mozambique,2002,9774105,8990042,13501744,5637914,18764147
Mozambique,2003,10059816,9271281,13873191,5843407,19331097
Mozambique,2004,10351803,9558746,14255830,6056875,19910549
Mozambique,2005,10645921,9848006,14646262,6276808,20493927
Mozambique,2006,10941733,10138375,15044085,6503378,21080108
Mozambique,2007,11241381,10431938,15451006,6737381,21673319
Mozambique,2008,11546279,10730317,15802686,7044072,22276596
Mozambique,2009,11858644,11036074,16154357,7369706,22894718
Mozambique,2010,12180274,11351293,16511748,7709657,23531567
Mozambique,2011,12511359,11676141,16874793,8064212,24187500
Mozambique,2012,12852030,12010643,17242761,8433845,24862673
Mozambique,2013,13204033,12356719,17615928,8818444,25560752
Mozambique,2014,13569528,12716664,17993425,9218957,26286192
Mozambique,2015,13949963,13092038,18375089,9635602,27042001
Mozambique,2016,14346169,13483761,18760441,10069035,27829930
Mozambique,2017,14757711,13891296,19149788,10519046,28649007
Mozambique,2018,15183127,14312882,19542053,10986620,29496009
Myanmar,2000,24089960,22629738,33637935,12457527,46719698
Myanmar,2001,24361274,22863845,33941554,12686440,47225119
Myanmar,2002,24614137,23088026,34228006,12912214,47702163
Myanmar,2003,24849529,23299378,34492260,13132634,48148907
Myanmar,2004,25069955,23494534,34728333,13345374,48564489
Myanmar,2005,25277966,23671965,34933870,13548744,48949931
Myanmar,2006,25472149,23828900,35105021,13741453,49301049
Myanmar,2007,25653374,23968105,35246670,13924916,49621479
Myanmar,2008,25829264,24100378,35374487,14105265,49929642
Myanmar,2009,26009931,24240435,35510138,14290552,50250366
Myanmar,2010,26202319,24398508,35668447,14487449,50600827
Myanmar,2011,26410740,24579872,35854775,14698256,50990612
Myanmar,2012,26632792,24780911,36064794,14921720,51413703
Myanmar,2013,26860456,24992008,36292944,15155252,51852464
Myanmar,2014,27081937,25198879,36528875,15395307,52280816
Myanmar,2015,27289147,25391577,36757132,15646537,52680724
Myanmar,2016,27478828,25566371,36976382,15908841,53045199
Myanmar,2017,27654918,25727603,37187526,16183083,53382521
Myanmar,2018,27825150,25883168,37387374,16468361,53708318
Namibia,2000,929285,865298,1284412,614845,1794583
Namibia,2001,944378,879289,1297490,636106,1823667
Namibia,2002,958790,892729,1299607,662540,1851519
Namibia,2003,973006,906107,1297022,689513,1879113
Namibia,2004,987688,920049,1292615,716613,1907737
Namibia,2005,1003312,935004,1287768,744428,1938316
Namibia,2006,1020109,951209,1282581,773153,1971318
Namibia,2007,1037962,968554,1277117,802798,2006516
Namibia,2008,1056630,986752,1272323,834052,2043382
Namibia,2009,1075691,1005348,1269370,867670,2081039
Namibia,2010,1094862,1024015,1268790,904380,2118877
Namibia,2011,1114054,1042644,1270945,944676,2156698
Namibia,2012,1133400,1061377,1274757,989177,2194777
Namibia,2013,1153085,1080421,1279729,1036790,2233506
Namibia,2014,1173378,1100048,1284455,1086537,2273426
Namibia,2015,1194451,1120450,1287973,1137588,2314901
Namibia,2016,1216363,1141681,1290418,1189295,2358044
Namibia,2017,1238996,1163627,1292108,1241686,2402623
Namibia,2018,1262189,1186111,1293060,1294741,2448300
Nepal,2000,12021350,11919749,20560410,3180501,23941099
Nepal,2001,12243832,12103281,20791897,3369880,24347113
Nepal,2002,12443825,12281800,21068143,3498199,24725625
Nepal,2003,12625173,12455707,21323411,3627212,25080880
Nepal,2004,12794317,12625020,21553302,3756147,25419337
Nepal,2005,12956564,12787936,21756151,3884136,25744500
Nepal,2006,13112894,12953793,21929706,4010912,26066687
Nepal,2007,13263376,13119210,22078011,4136836,26382586
Nepal,2008,13411546,13255035,22211953,4263906,26666581
Nepal,2009,13561500,13322031,22346548,4394555,26883531
Nepal,2010,13716597,13296610,22491798,4531339,27013207
Nepal,2011,13877399,13163821,22651895,4675252,27041220
Nepal,2012,14044548,12944612,22822896,4827029,26989160
Nepal,2013,14221340,12695455,22999677,4985633,26916795
Nepal,2014,14411527,12494455,23173611,5149630,26905982
Nepal,2015,14617070,12397963,23338483,5317799,27015033
Nepal,2016,14839974,12423456,23492872,5489899,27263430
Nepal,2017,15077724,12554958,23638570,5666428,27632682
Nepal,2018,15322093,12773619,23776364,5847671,28095712
Netherlands,2000,8037448,7888740,3695706,12230482,15926188
Netherlands,2001,8082769,7935343,3551153,12466961,16018112
Netherlands,2002,8127782,7982573,3364924,12745431,16110355
Netherlands,2003,8171578,8029370,3184995,13015956,16200948
Netherlands,2004,8212956,8074227,3010783,13276399,16287183
Netherlands,2005,8251077,8116075,2842946,13524212,16367152
Netherlands,2006,8285527,8154564,2690294,13749928,16440091
Netherlands,2007,8316611,8190040,2552168,13954888,16506651
Netherlands,2008,8345105,8223000,2418707,14150027,16568105
Netherlands,2009,8372137,8254242,2279916,14347010,16626379
Netherlands,2010,8398523,8284404,2146443,14536474,16682927
Netherlands,2011,8424607,8313584,2028656,14708346,16738191
Netherlands,2012,8450160,8341690,1915976,14873119,16791850
Netherlands,2013,8474706,8368806,1820817,15018882,16843512
Netherlands,2014,8497505,8395012,1741230,15148126,16892517
Netherlands,2015,8518105,8420387,1664620,15273879,16938492
Netherlands,2016,8536309,8444976,1590832,15396498,16981285
Netherlands,2017,8552503,8468840,1520119,15515819,17021343
Netherlands,2018,8567472,8492088,1453872,15630587,17059560
New Zealand,2000,1965009,1893983,539447,3319552,3858992
New Zealand,2001,1991290,1916651,543196,3364737,3907941
New Zealand,2002,2020580,1942622,548484,3414722,3963202
New Zealand,2003,2051409,1970665,554208,3467861,4022074
New Zealand,2004,2081594,1998827,559799,3520639,4080421
New Zealand,2005,2109605,2025748,564865,3570490,4135353
New Zealand,2006,2134897,2050985,569292,3616625,4185882
New Zealand,2007,2158032,2075014,578237,3654914,4233046
New Zealand,2008,2179843,2098313,586969,3691356,4278156
New Zealand,2009,2201622,2121716,595754,3727728,4323338
New Zealand,2010,2224297,2145763,604805,3765257,4370060
New Zealand,2011,2248094,2170580,614145,3804220,4418674
New Zealand,2012,2272628,2195834,618306,3849437,4468462
New Zealand,2013,2297464,2221055,622479,3895048,4518519
New Zealand,2014,2321933,2245589,626516,3940184,4567522
New Zealand,2015,2345566,2268961,630320,3984212,4614527
New Zealand,2016,2368249,2291016,633866,4026967,4659265
New Zealand,2017,2390131,2311898,636894,4068924,4702029
New Zealand,2018,2411302,2331829,639408,4110189,4743131
Nicaragua,2000,2561997,2507313,2252737,2774059,5069310
Nicaragua,2001,2601423,2543944,2278271,2822479,5145367
Nicaragua,2002,2639908,2579416,2302257,2869477,5219324
Nicaragua,2003,2677899,2614216,2325221,2915658,5292115
Nicaragua,2004,2715975,2648955,2347830,2961873,5364930
Nicaragua,2005,2754553,2684139,2370424,3008904,5438692
Nicaragua,2006,2793837,2719920,2390923,3059288,5513757
Nicaragua,2007,2833769,2756297,2411595,3110511,5590066
Nicaragua,2008,2874141,2793295,2432201,3162305,5667436
Nicaragua,2009,2914633,2830905,2452422,3214159,5745538
Nicaragua,2010,2954978,2869080,2471956,3265767,5824058
Nicaragua,2011,2995158,2907877,2490775,3317045,5903035
Nicaragua,2012,3035243,2947287,2508971,3368137,5982530
Nicaragua,2013,3075329,2987133,2526665,3419082,6062462
Nicaragua,2014,3115567,3027167,2543925,3470072,6142734
Nicaragua,2015,3156054,3067180,2560844,3521191,6223234
Nicaragua,2016,3196840,3107130,2577435,3572493,6303970
Nicaragua,2017,3237844,3146999,2592801,3624780,6384843
Nicaragua,2018,3278831,3186671,2606772,3677985,6465502
Niger,2000,5718338,5613223,9515369,1837604,11331561
Niger,2001,5923618,5827746,9857911,1914065,11751364
Niger,2002,6138148,6051840,10221895,1984107,12189988
Niger,2003,6362294,6285689,10600022,2056848,12647983
Niger,2004,6596448,6529466,10994331,2132681,13125914
Niger,2005,6841020,6783454,11406515,2211934,13624474
Niger,2006,7096222,7047747,11837319,2294745,14143969
Niger,2007,7362489,7322915,12287148,2381190,14685404
Niger,2008,7640715,7610198,12757057,2471468,15250913
Niger,2009,7931954,7911177,13248124,2565789,15843131
Niger,2010,8237013,8227012,13761257,2664321,16464025
Niger,2011,8556418,8558352,14297394,2767242,17114770
Niger,2012,8890161,8905048,14856997,2874637,17795209
Niger,2013,9237798,9266489,15439900,2986472,18504287
Niger,2014,9598588,9641594,16042540,3105679,19240182
Niger,2015,9972036,10029627,16664382,3232583,20001663
Niger,2016,10358188,10430601,17305349,3367638,20788789
Niger,2017,10757444,10844944,17965903,3511445,21602388
Niger,2018,11170022,11272809,18646683,3664692,22442831
Nigeria,2000,60635479,61648374,79724569,42627440,122283853
Nigeria,2001,62157695,63236351,80711492,44751942,125394046
Nigeria,2002,63724089,64871990,81692471,46974239,128596079
Nigeria,2003,65339999,66560634,82673013,49299520,131900633
Nigeria,2004,67011754,68308666,83656546,51737070,135320420
Nigeria,2005,68744169,70120845,84650560,54288918,138865014
Nigeria,2006,70539247,71999058,85649313,56964781,142538305
Nigeria,2007,72396969,73943002,86650758,59766266,146339971
Nigeria,2008,74317325,75952297,87649227,62698163,150269622
Nigeria,2009,76299389,78025550,88645241,65756940,154324939
Nigeria,2010,78342012,80161191,89628433,68949828,158503203
Nigeria,2011,80445630,82359450,90614743,72262333,162805080
Nigeria,2012,82609445,84619358,91602273,75695011,167228803
Nigeria,2013,84829345,86936474,92584883,79244420,171765819
Nigeria,2014,87099897,89305034,93555299,82905203,176404931
Nigeria,2015,89416890,91720564,94508650,86673094,181137454
Nigeria,2016,91778862,94181382,95443463,90546177,185960244
Nigeria,2017,94185842,96687405,96361295,94525016,190873247
Nigeria,2018,96636957,99237728,97264436,98610801,195874685
Norway,2000,2270364,2229011,1078958,3420409,4499375
Norway,2001,2282000,2241139,1068456,3454689,4523139
Norway,2002,2293372,2252645,1057720,3488299,4546017
Norway,2003,2305223,2264873,1047270,3522836,4570096
Norway,2004,2318562,2279648,1039256,3558958,4598210
Norway,2005,2334113,2298246,1034154,3598210,4632359
Norway,2006,2351996,2320990,1030404,3642666,4672986
Norway,2007,2372001,2347402,1027294,3692354,4719403
Norway,2008,2394041,2376973,1024598,3746810,4771014
Norway,2009,2417937,2408910,1022628,3804552,4826847
Norway,2010,2443436,2442442,1021067,3864811,4885878
Norway,2011,2470696,2477639,1016484,3931111,4948335
Norway,2012,2499451,2514265,1008706,4003301,5013716
Norway,2013,2528527,2550933,1000906,4076195,5079460
Norway,2014,2556393,2585876,992506,4147805,5142269
Norway,2015,2581959,2617868,983228,4216608,5199827
Norway,2016,2604692,2646258,972918,4281776,5250950
Norway,2017,2624939,2671385,961814,4343569,5296324
Norway,2018,2643605,2694355,950323,4403040,5337960
Oman,2000,994726,1273247,644819,1623172,2267973
Oman,2001,1014040,1280919,652896,1641891,2294959
Oman,2002,1033598,1301261,664600,1669685,2334859
Oman,2003,1053129,1333035,679589,1705666,2386164
Oman,2004,1072245,1373279,688770,1755981,2445524
Oman,2005,1090903,1420351,693105,1818164,2511254
Oman,2006,1108494,1472259,698251,1884740,2580753
Oman,2007,1125769,1531393,704911,1957851,2657162
Oman,2008,1145584,1605372,715134,2043880,2750956
Oman,2009,1171774,1704412,731574,2151368,2876186
Oman,2010,1206887,1834548,755463,2285997,3041435
Oman,2011,1252026,1999076,771005,2466263,3251102
Oman,2012,1305847,2192184,777340,2687304,3498031
Oman,2013,1365279,2399526,783774,2927707,3764805
Oman,2014,1425908,2601347,786430,3174495,4027255
Oman,2015,1484395,2782946,783245,3416565,4267341
Oman,2016,1539787,2939430,774333,3650429,4479217
Oman,2017,1592566,3073360,762220,3874042,4665926
Oman,2018,1642702,3186774,746740,4083206,4829476
Pakistan,2000,68869890,73473693,92835896,45687389,142343583
Pakistan,2001,70641890,75336518,94617502,46983935,145978408
Pakistan,2002,72381875,77167820,96368659,48285484,149549695
Pakistan,2003,74108539,78984832,98104460,49598941,153093371
Pakistan,2004,75850289,80814409,99845050,50935250,156664698
Pakistan,2005,77627779,82676228,101607860,52301807,160304007
Pakistan,2006,79446945,84575681,103392912,53701081,164022626
Pakistan,2007,81301352,86506754,105200045,55132929,167808106
Pakistan,2008,83184598,88464386,107040193,56604410,171648984
Pakistan,2009,85085873,90439737,108927738,58121842,175525610
Pakistan,2010,86997654,92426989,110868669,59691513,179424643
Pakistan,2011,88917077,94423091,112867839,61316426,183340168
Pakistan,2012,90847991,96432134,114917348,62994185,187280125
Pakistan,2013,92797250,98463549,116999097,64713498,191260799
Pakistan,2014,94774652,100530360,119084632,66461625,195305012
Pakistan,2015,96786262,102640691,121153730,68226783,199426953
Pakistan,2016,98833941,104797415,123198205,70005271,203631356
Pakistan,2017,100912342,106993868,125220255,71795700,207906210
Pakistan,2018,103011525,109216763,127183388,73630430,212228288
Panama,2000,1503303,1527030,1145519,1884828,3030333
Panama,2001,1533084,1556557,1158733,1930951,3089641
Panama,2002,1563013,1586182,1171701,1977564,3149195
Panama,2003,1593119,1615937,1184467,2024707,3209056
Panama,2004,1623489,1645867,1197063,2072478,3269356
Panama,2005,1654192,1676030,1209565,2120900,3330222
Panama,2006,1685239,1706434,1221915,2169990,3391673
Panama,2007,1716603,1737068,1234105,2219702,3453671
Panama,2008,1748284,1767920,1246153,2270115,3516204
Panama,2009,1780242,1798973,1258135,2321250,3579215
Panama,2010,1812455,1830236,1270027,2373195,3642691
Panama,2011,1844847,1861632,1281524,2426258,3706479
Panama,2012,1877451,1893184,1292567,2480371,3770635
Panama,2013,1910409,1925038,1303066,2535396,3835447
Panama,2014,1943936,1957375,1312887,2591099,3901311
Panama,2015,1978158,1990332,1321936,2647313,3968490
Panama,2016,2013130,2023943,1330168,2703951,4037073
Panama,2017,2048694,2058070,1337579,2761008,4106764
Panama,2018,2084482,2092386,1344157,2818461,4176868
Papua New Guinea,2000,2875183,2972407,4836481,735741,5847590
Papua New Guinea,2001,2937346,3037281,4962641,753511,5974627
Papua New Guinea,2002,2997942,3100679,5090608,771708,6098621
Papua New Guinea,2003,3058879,3164499,5220577,790147,6223378
Papua New Guinea,2004,3122848,3231399,5352671,808846,6354247
Papua New Guinea,2005,3191689,3303213,5486901,827808,6494902
Papua New Guinea,2006,3266209,3380682,5623247,847025,6646891
Papua New Guinea,2007,3345527,3462976,5761463,866459,6808503
Papua New Guinea,2008,3427754,3548446,5901140,886047,6976200
Papua New Guinea,2009,3510130,3634644,6041735,905712,7144774
Papua New Guinea,2010,3590688,3719824,6182852,925387,7310512
Papua New Guinea,2011,3668765,3803431,6324300,945048,7472196
Papua New Guinea,2012,3745032,3885971,6466137,964699,7631003
Papua New Guinea,2013,3820350,3968038,6607438,985427,7788388
Papua New Guinea,2014,3896120,4050613,6748445,1007340,7946733
Papua New Guinea,2015,3973383,4134389,6889286,1030539,8107772
Papua New Guinea,2016,4052305,4219461,7029890,1055101,8271766
Papua New Guinea,2017,4132522,4305516,7170073,1081089,8438038
Papua New Guinea,2018,4213891,4392433,7309758,1108588,8606324
Paraguay,2000,2622196,2701006,2368649,2934051,5323202
Paraguay,2001,2673716,2754726,2380757,3025867,5428442
Paraguay,2002,2724462,2807496,2390764,3117847,5531958
Paraguay,2003,2773955,2859028,2412728,3195222,5632983
Paraguay,2004,2821589,2908967,2435187,3268553,5730556
Paraguay,2005,2866969,2957126,2455395,3340099,5824095
Paraguay,2006,2909899,3003313,2473144,3409652,5913212
Paraguay,2007,2950679,3047751,2488720,3477439,5998430
Paraguay,2008,2990188,3091108,2502774,3544343,6081296
Paraguay,2009,3029658,3134312,2516303,3611534,6163970
Paraguay,2010,3069988,3178029,2529866,3680011,6248017
Paraguay,2011,3111467,3222514,2543703,3750080,6333981
Paraguay,2012,3153912,3267598,2557635,3821584,6421510
Paraguay,2013,3197206,3313067,2573579,3892161,6510273
Paraguay,2014,3241014,3358510,2590005,3962579,6599524
Paraguay,2015,3285105,3403641,2605873,4033246,6688746
Paraguay,2016,3329476,3448402,2621149,4104158,6777878
Paraguay,2017,3374176,3492882,2635972,4175325,6867058
Paraguay,2018,3419020,3537049,2649475,4247433,6956069
Peru,2000,13269175,13190769,6986192,18928687,26459944
Peru,2001,13438634,13360655,6972982,19288381,26799289
Peru,2002,13589979,13510985,6956188,19645279,27100964
Peru,2003,13726371,13645846,6936737,20001001,27372217
Peru,2004,13852761,13771465,6915339,20357855,27624226
Peru,2005,13973343,13892797,6893135,20717275,27866140
Peru,2006,14089686,14012369,6869848,21080096,28102055
Peru,2007,14202697,14130353,6845868,21446856,28333050
Peru,2008,14315467,14246854,6859120,21782860,28562321
Peru,2009,14431447,14361216,6890339,22111168,28792663
Peru,2010,14553781,14473899,6923397,22450249,29027680
Peru,2011,14681706,14582608,6958683,22801306,29264314
Peru,2012,14816488,14690302,6995686,23163280,29506790
Peru,2013,14965316,14808670,7033463,23532253,29773986
Peru,2014,15137234,14953138,7070179,23903175,30090372
Peru,2015,15337374,15133365,7104742,24271929,30470739
Peru,2016,15570375,15355661,7136697,24637142,30926036
Peru,2017,15831044,15613255,7166470,24999015,31444299
Peru,2018,16102678,15886587,7191715,25360100,31989265
Philippines,2000,38710923,39280834,42010504,35981065,77991757
Philippines,2001,39568586,40104283,42979692,36685623,79672869
Philippines,2002,40436783,40928477,43958821,37393239,81365260
Philippines,2003,41300381,41751589,44937089,38094865,83051970
Philippines,2004,42139061,42571483,45900211,38778282,84710544
Philippines,2005,42939599,43386652,46838332,39435905,86326251
Philippines,2006,43693432,44195243,47746310,40063109,87888675
Philippines,2007,44408074,44997408,48629037,40664453,89405482
Philippines,2008,45105958,45796009,49500348,41251516,90901967
Philippines,2009,45818894,46595267,50379709,41841170,92414161
Philippines,2010,46569078,47397706,51238690,42487934,93966784
Philippines,2011,47365188,48204861,51905589,43372351,95570049
Philippines,2012,48198297,49014342,52586504,44280138,97212639
Philippines,2013,49051547,49820011,53275654,45205378,98871558
Philippines,2014,49899689,50613448,53961963,46140286,100513137
Philippines,2015,50724446,51388760,54638160,47078199,102113206
Philippines,2016,51520471,52143341,55302333,48017889,103663812
Philippines,2017,52293623,52879298,55939801,48978289,105172921
Philippines,2018,53050171,53601223,56550096,49961978,106651394
Poland,2000,19838508,18718191,14758595,23791900,38556699
Poland,2001,19834121,18695464,14731334,23792671,38529585
Poland,2002,19823275,18665365,14706001,23778471,38488640
Poland,2003,19809670,18632151,14731403,23707423,38441821
Poland,2004,19798158,18601395,14757919,23638147,38399553
Poland,2005,19791955,18577002,14787876,23574790,38368957
Poland,2006,19793483,18560964,14822414,23518622,38354447
Poland,2007,19801199,18552140,14860895,23468690,38353339
Poland,2008,19809415,18547371,14902394,23423295,38356786
Poland,2009,19810049,18541875,14945010,23379860,38351924
Poland,2010,19797591,18532193,14987475,23335927,38329784
Poland,2011,19769575,18517249,15029607,23291340,38286824
Poland,2012,19728760,18498273,15076293,23241111,38227033
Poland,2013,19681293,18476750,15121151,23188300,38158043
Poland,2014,19636037,18455058,15162767,23130293,38091095
Poland,2015,19599276,18434800,15199849,23065377,38034076
Poland,2016,19572973,18416245,15221747,23002663,37989218
Poland,2017,19554759,18398417,15228329,22942383,37953176
Poland,2018,19541261,18380324,15219933,22884899,37921585
Portugal,2000,5331393,4965724,4721990,5633127,10297117
Portugal,2001,5350698,4990758,4675151,5724161,10341456
Portugal,2002,5369226,5016767,4630074,5813594,10385993
Portugal,2003,5387737,5041878,4584232,5902881,10429615
Portugal,2004,5407332,5063594,4536981,5991287,10470926
Portugal,2005,5428528,5079966,4488055,6077668,10508494
Portugal,2006,5452000,5090837,4437475,6162476,10542837
Portugal,2007,5476774,5096376,4385066,6245054,10573150
Portugal,2008,5499769,5095543,4329158,6322941,10595312
Portugal,2009,5516866,5087200,4268076,6392540,10604066
Portugal,2010,5525179,5070876,4200496,6451825,10596055
Portugal,2011,5523540,5045848,4126096,6499233,10569388
Portugal,2012,5513130,5013178,4046172,6535649,10526308
Portugal,2013,5496470,4976555,3963418,6564256,10473025
Portugal,2014,5477285,4940939,3881018,6590150,10418224
Portugal,2015,5458378,4909968,3801276,6617197,10368346
Portugal,2016,5440513,4885027,3724867,6646760,10325540
Portugal,2017,5423127,4865400,3651305,6678201,10288527
Portugal,2018,5406240,4849952,3580203,6710993,10256192
Qatar,2000,206134,386333,21850,570417,592467
Qatar,2001,216184,398829,21554,595332,615013
Qatar,2002,227883,412989,21361,624298,640872
Qatar,2003,241979,439812,21570,667016,681791
Qatar,2004,259402,493930,22085,736770,753332
Qatar,2005,280764,584646,22523,842340,865410
Qatar,2006,306132,716572,23534,986848,1022704
Qatar,2007,335121,883320,24776,1164857,1218441
Qatar,2008,367134,1069536,25861,1363481,1436670
Qatar,2009,401364,1253580,26467,1564313,1654944
Qatar,2010,437040,1419289,26680,1752996,1856329
Qatar,2011,474133,1561729,27283,1924771,2035862
Qatar,2012,512270,1683807,27484,2082083,2196077
Qatar,2013,549808,1786771,27334,2223139,2336579
Qatar,2014,584693,1874509,26882,2347537,2459202
Qatar,2015,615499,1950209,26186,2455353,2565708
Qatar,2016,641459,2012920,25324,2544480,2654379
Qatar,2017,662996,2061731,24338,2614873,2724727
Qatar,2018,681381,2100301,23303,2671546,2781682
Republic of Korea,2000,23607326,23771911,9656885,37729427,47379237
Republic of Korea,2001,23770735,23935491,9571083,38141705,47706226
Republic of Korea,2002,23916724,24082827,9457554,38547232,47999551
Republic of Korea,2003,24046876,24214025,9338132,38926894,48260901
Republic of Korea,2004,24163800,24329634,9213825,39284258,48493434
Republic of Korea,2005,24270131,24430938,9086487,39622010,48701069
Republic of Korea,2006,24364588,24515861,9031912,39863933,48880449
Republic of Korea,2007,24448334,24586479,9012350,40050079,49034813
Republic of Korea,2008,24529334,24653124,8990762,40228223,49182458
Republic of Korea,2009,24617963,24729487,8969877,40409331,49347450
Republic of Korea,2010,24721013,24824625,8951241,40601614,49545638
Republic of Korea,2011,24842539,24943614,8992550,40752109,49786153
Republic of Korea,2012,24978879,25081760,9065944,40886300,50060639
Republic of Korea,2013,25119446,25226274,9141362,41027880,50345720
Republic of Korea,2014,25249141,25358763,9217129,41168431,50607904
Republic of Korea,2015,25357063,25466024,9291811,41301851,50823087
Republic of Korea,2016,25439687,25543759,9365142,41426777,50983446
Republic of Korea,2017,25500317,25596091,9429948,41552264,51096408
Republic of Korea,2018,25543317,25628383,9486209,41678226,51171700
Republic of Moldova,2000,2191164,2011495,2327849,1873240,4202659
Republic of Moldova,2001,2182777,2004320,2335976,1849529,4187097
Republic of Moldova,2002,2178125,2000103,2347732,1828884,4178228
Republic of Moldova,2003,2175545,1997731,2361602,1810044,4173276
Republic of Moldova,2004,2172522,1995440,2375227,1791110,4167962
Republic of Moldova,2005,2167304,1991992,2379259,1778440,4159296
Republic of Moldova,2006,2159274,1986990,2373123,1771607,4146264
Republic of Moldova,2007,2149197,1980932,2365195,1763454,4130129
Republic of Moldova,2008,2138379,1974507,2356613,1754827,4112886
Republic of Moldova,2009,2128732,1968783,2349053,1746987,4097515
Republic of Moldova,2010,2121606,1964484,2343690,1740791,4086090
Republic of Moldova,2011,2117367,1961800,2340872,1736496,4079167
Republic of Moldova,2012,2115452,1960352,2340031,1733672,4075804
Republic of Moldova,2013,2115068,1959517,2340291,1731673,4074585
Republic of Moldova,2014,2115033,1958374,2340388,1729551,4073407
Republic of Moldova,2015,2114438,1956267,2338327,1727653,4070705
Republic of Moldova,2016,2113043,1952970,2333836,1725772,4066013
Republic of Moldova,2017,2111038,1948649,2327145,1724067,4059687
Republic of Moldova,2018,2108455,1943495,2318419,1722646,4051950
Romania,2000,11307672,10829751,10399242,11728886,22137423
Romania,2001,11240589,10748765,10365175,11618960,21989354
Romania,2002,11178746,10674532,10319721,11534955,21853278
Romania,2003,11118101,10602302,10231821,11497098,21720403
Romania,2004,11052729,10525161,10138587,11452577,21577890
Romania,2005,10978711,10438576,10035316,11395702,21417287
Romania,2006,10894254,10340058,9919852,11324070,21234312
Romania,2007,10801643,10232553,9795242,11240869,21034196
Romania,2008,10705935,10123586,9667799,11153285,20829521
Romania,2009,10614323,10023672,9546514,11071441,20637995
Romania,2010,10531842,9940018,9437516,11002831,20471860
Romania,2011,10460697,9876021,9342912,10950055,20336718
Romania,2012,10398994,9828473,9283979,10887276,20227467
Romania,2013,10342820,9789960,9243988,10824213,20132780
Romania,2014,10286299,9749629,9207431,10765305,20035928
Romania,2015,10225320,9699862,9165608,10711013,19925182
Romania,2016,10158400,9637880,9117772,10660311,19796280
Romania,2017,10087350,9566616,9065003,10614303,19653966
Romania,2018,10015167,9490943,9007536,10573098,19506110
Russian Federation,2000,77901579,68503311,39014773,107381741,146404890
Russian Federation,2001,77664284,68166442,38866125,106948739,145830726
Russian Federation,2002,77413911,67801796,38707217,106487665,145215707
Russian Federation,2003,77172583,67438293,38498936,106085759,144610876
Russian Federation,2004,76968159,67112490,38290132,105754475,144080649
Russian Federation,2005,76820863,66851262,38112227,105505958,143672125
Russian Federation,2006,76738066,66665191,37969435,105353498,143403257
Russian Federation,2007,76715932,66550274,37859367,105290775,143266206
Russian Federation,2008,76748853,66499910,37777378,105305809,143248763
Russian Federation,2009,76826081,66500823,37715868,105376897,143326904
Russian Federation,2010,76937777,66541496,37667890,105485979,143479273
Russian Federation,2011,77082440,66620587,37632802,105631186,143703027
Russian Federation,2012,77257165,66736723,37589599,105830998,143993888
Russian Federation,2013,77448177,66877278,37531491,106065739,144325455
Russian Federation,2014,77638342,67026494,37449924,106311454,144664836
Russian Federation,2015,77813704,67171355,37338513,106549491,144985059
Russian Federation,2016,77968782,67306592,37194234,106770279,145275374
Russian Federation,2017,78101045,67429046,37017128,106972626,145530091
Russian Federation,2018,78203451,67530583,36807854,107156855,145734034
Rwanda,2000,4057739,3875949,6827783,1197920,7933688
Rwanda,2001,4207424,4023726,7010937,1318469,8231150
Rwanda,2002,4306107,4120953,7104058,1432147,8427060
Rwanda,2003,4371762,4185398,7213040,1467306,8557160
Rwanda,2004,4434020,4246496,7327409,1491029,8680516
Rwanda,2005,4514517,4325703,7471017,1520718,8840220
Rwanda,2006,4616849,4426493,7649129,1557451,9043342
Rwanda,2007,4732973,4540786,7848805,1598597,9273759
Rwanda,2008,4859345,4665187,8065028,1643141,9524532
Rwanda,2009,4989389,4793381,8288298,1689148,9782770
Rwanda,2010,5118459,4920879,8511644,1735198,10039338
Rwanda,2011,5246075,5047258,8734828,1781243,10293333
Rwanda,2012,5374743,5174925,8960938,1827915,10549668
Rwanda,2013,5506169,5305369,9189947,1875204,10811538
Rwanda,2014,5642837,5440792,9420354,1925003,11083629
Rwanda,2015,5786418,5582648,9652086,1977467,11369066
Rwanda,2016,5937449,5731380,9884801,2032707,11668829
Rwanda,2017,6094897,5886063,10117663,2090744,11980960
Rwanda,2018,6256912,6045057,10349599,2151557,12301969
Saint Lucia,2000,79857,76880,113358,43591,156737
Saint Lucia,2001,80606,77578,114930,43534,158184
Saint Lucia,2002,81235,78157,117699,42064,159392
Saint Lucia,2003,81830,78700,120382,40591,160530
Saint Lucia,2004,82481,79340,123095,39156,161821
Saint Lucia,2005,83271,80137,125920,37794,163408
Saint Lucia,2006,84229,81149,128905,36502,165378
Saint Lucia,2007,85322,82322,132017,35271,167644
Saint Lucia,2008,86462,83549,135155,34065,170011
Saint Lucia,2009,87514,84709,138164,32858,172223
Saint Lucia,2010,88414,85678,140739,31841,174092
Saint Lucia,2011,89119,86419,141760,32072,175538
Saint Lucia,2012,89669,86985,142578,32256,176654
Saint Lucia,2013,90095,87410,143232,32427,177505
Saint Lucia,2014,90501,87806,143814,32607,178307
Saint Lucia,2015,90920,88211,144397,32809,179131
Saint Lucia,2016,91373,88655,144979,33036,180028
Saint Lucia,2017,91838,89117,145557,33287,180955
Saint Lucia,2018,92310,89580,146110,33557,181890
Saint Vincent and the Grenadines,2000,53487,54300,59144,48754,107787
Saint Vincent and the Grenadines,2001,53506,54387,58802,49186,107893
Saint Vincent and the Grenadines,2002,53589,54506,58492,49654,108095
Saint Vincent and the Grenadines,2003,53679,54643,58202,50148,108322
Saint Vincent and the Grenadines,2004,53747,54773,57910,50649,108520
Saint Vincent and the Grenadines,2005,53745,54872,57599,51145,108617
Saint Vincent and the Grenadines,2006,53664,54938,57272,51635,108602
Saint Vincent and the Grenadines,2007,53536,54980,56929,52118,108516
Saint Vincent and the Grenadines,2008,53387,55014,56569,52596,108401
Saint Vincent and the Grenadines,2009,53240,55053,56190,53063,108293
Saint Vincent and the Grenadines,2010,53158,55102,55793,53522,108260
Saint Vincent and the Grenadines,2011,53138,55177,55375,53966,108315
Saint Vincent and the Grenadines,2012,53176,55259,54933,54395,108435
Saint Vincent and the Grenadines,2013,53265,55359,54491,54829,108624
Saint Vincent and the Grenadines,2014,53399,55469,54068,55289,108868
Saint Vincent and the Grenadines,2015,53554,55581,53672,55783,109135
Saint Vincent and the Grenadines,2016,53758,55709,53316,56327,109467
Saint Vincent and the Grenadines,2017,53985,55841,52988,56909,109826
Saint Vincent and the Grenadines,2018,54233,55977,52678,57522,110210
Samoa,2000,83572,90882,136236,38374,174454
Samoa,2001,84075,91319,136822,38744,175394
Samoa,2002,84648,91762,137838,38744,176410
Samoa,2003,85279,92202,139113,38549,177481
Samoa,2004,85938,92659,140420,38361,178597
Samoa,2005,86593,93129,141752,38177,179722
Samoa,2006,87249,93625,143099,37995,180874
Samoa,2007,87907,94138,144461,37825,182045
Samoa,2008,88580,94690,145859,37667,183270
Samoa,2009,89259,95294,147306,37520,184553
Samoa,2010,89965,95979,148819,37386,185944
Samoa,2011,90703,96766,150399,37266,187469
Samoa,2012,91465,97624,152067,37127,189089
Samoa,2013,92210,98502,153778,36979,190712
Samoa,2014,92891,99329,155469,36821,192220
Samoa,2015,93473,100037,157111,36648,193510
Samoa,2016,93934,100606,158673,36452,194540
Samoa,2017,94297,101061,160194,36246,195358
Samoa,2018,94644,101484,161629,36066,196128
Sao Tome and Principe,2000,71980,70284,64557,74049,142264
Sao Tome and Principe,2001,73254,71506,64613,77009,144760
Sao Tome and Principe,2002,74623,72827,64397,80492,147450
Sao Tome and Principe,2003,76102,74303,64146,84226,150405
Sao Tome and Principe,2004,77740,75996,63870,88099,153736
Sao Tome and Principe,2005,79534,77938,63552,92078,157472
Sao Tome and Principe,2006,81512,80164,63176,96152,161676
Sao Tome and Principe,2007,83654,82643,62761,100340,166297
Sao Tome and Principe,2008,85878,85244,62291,104622,171122
Sao Tome and Principe,2009,88090,87787,61795,109018,175877
Sao Tome and Principe,2010,90215,90157,61256,113520,180372
Sao Tome and Principe,2011,92212,92309,60678,118122,184521
Sao Tome and Principe,2012,94123,94271,60061,122828,188394
Sao Tome and Principe,2013,95965,96111,59465,127580,192076
Sao Tome and Principe,2014,97807,97920,58885,132381,195727
Sao Tome and Principe,2015,99667,99772,58325,137228,199439
Sao Tome and Principe,2016,101555,101666,57790,142120,203221
Sao Tome and Principe,2017,103476,103610,57276,147051,207086
Sao Tome and Principe,2018,105439,105593,56792,152026,211032
Saudi Arabia,2000,9415348,11248492,4184486,16579826,20663840
Saudi Arabia,2001,9633879,11568767,4244343,17059249,21202646
Saudi Arabia,2002,9852692,11952630,4314583,17591725,21805322
Saudi Arabia,2003,10075877,12380768,4391752,18164673,22456645
Saudi Arabia,2004,10308767,12823919,4470674,18758216,23132686
Saudi Arabia,2005,10555254,13260921,4546990,19358664,23816175
Saudi Arabia,2006,10814704,13683609,4619627,19958674,24498313
Saudi Arabia,2007,11085954,14098635,4690056,20562513,25184589
Saudi Arabia,2008,11371436,14517099,4760487,21180283,25888535
Saudi Arabia,2009,11673941,14956362,4834475,21827017,26630303
Saudi Arabia,2010,11993977,15427491,4913575,22512101,27421468
Saudi Arabia,2011,12335152,15932439,4997624,23240396,28267591
Saudi Arabia,2012,12693016,16461890,5084189,24002168,29154906
Saudi Arabia,2013,13050172,17001886,5168517,24775959,30052058
Saudi Arabia,2014,13383388,17533215,5244480,25532242,30916603
Saudi Arabia,2015,13676743,18040933,5307901,26249243,31717676
Saudi Arabia,2016,13922113,18521330,5357473,26918214,32443443
Saudi Arabia,2017,14126063,18975120,5394590,27543623,33101183
Saudi Arabia,2018,14305421,19397336,5421205,28133138,33702757
Senegal,2000,4984265,4813466,5898768,3985284,9797731
Senegal,2001,5112947,4923155,6033724,4100773,10036102
Senegal,2002,5245441,5038253,6175004,4221857,10283694
Senegal,2003,5382445,5159025,6306742,4364248,10541470
Senegal,2004,5524666,5285420,6430464,4525480,10810086
Senegal,2005,5672670,5417453,6557896,4693370,11090123
Senegal,2006,5826759,5555513,6688611,4868152,11382272
Senegal,2007,5987040,5700038,6823185,5050372,11687078
Senegal,2008,6153634,5851066,6962724,5241233,12004700
Senegal,2009,6326583,6008509,7108938,5441979,12335092
Senegal,2010,6505829,6172314,7262417,5653812,12678143
Senegal,2011,6691454,6342360,7423569,5877341,13033814
Senegal,2012,6883286,6518704,7591270,6112243,13401990
Senegal,2013,7080691,6701738,7763486,6356834,13782429
Senegal,2014,7282813,6891927,7936955,6609156,14174740
Senegal,2015,7488962,7089488,8108284,6868710,14578450
Senegal,2016,7698901,7294613,8276576,7135037,14993514
Senegal,2017,7912575,7506779,8442004,7408563,15419354
Senegal,2018,8129674,7724650,8604629,7689641,15854324
Serbia,2006,4668263,4477650,4210060,4963229,9145913
Serbia,2007,4644608,4456581,4172279,4962934,9101189
Serbia,2008,4622340,4437765,4135754,4963798,9060105
Serbia,2009,4602236,4421118,4099850,4964906,9023354
Serbia,2010,4584789,4406469,4063980,4965736,8991258
Serbia,2011,4570070,4393691,4027867,4965879,8963761
Serbia,2012,4557652,4382464,3998797,4958187,8940116
Serbia,2013,4546771,4372121,3972253,4947962,8918892
Serbia,2014,4536403,4361881,3946346,4938366,8898284
Serbia,2015,4525705,4351072,3921443,4929837,8876777
Serbia,2016,4514482,4339481,3897595,4922488,8853963
Serbia,2017,4502638,4326985,3872979,4917595,8829623
Serbia,2018,4489620,4313121,3847250,4914777,8802741
Seychelles,2000,40640,40358,40224,40927,80998
Seychelles,2001,41389,41024,40750,41817,82413
Seychelles,2002,42259,41818,41364,42839,84077
Seychelles,2003,43127,42680,41990,43920,85807
Seychelles,2004,43859,43529,42528,44956,87388
Seychelles,2005,44353,44299,42890,45854,88652
Seychelles,2006,44541,44987,43064,46595,89528
Seychelles,2007,44495,45587,43077,47204,90082
Seychelles,2008,44315,46135,42968,47718,90450
Seychelles,2009,44160,46628,42814,48220,90788
Seychelles,2010,44181,47092,42653,48752,91273
Seychelles,2011,44376,47506,42501,49333,91882
Seychelles,2012,44729,47879,42340,49945,92608
Seychelles,2013,45177,48220,42174,50591,93397
Seychelles,2014,45661,48553,41993,51261,94214
Seychelles,2015,46104,48877,41809,51933,94981
Seychelles,2016,46506,49205,41619,52609,95711
Seychelles,2017,46883,49535,41437,53300,96418
Seychelles,2018,47241,49853,41246,53989,97094
Sierra Leone,2000,2310786,2273784,2938242,1626055,4584570
Sierra Leone,2001,2395283,2358786,3039370,1699777,4754069
Sierra Leone,2002,2501018,2464752,3167216,1790000,4965770
Sierra Leone,2003,2618613,2582461,3309412,1890137,5201074
Sierra Leone,2004,2734985,2699010,3448988,1990707,5433995
Sierra Leone,2005,2840596,2805033,3569351,2089027,5645629
Sierra Leone,2006,2932053,2897187,3666929,2181763,5829240
Sierra Leone,2007,3011782,2977859,3748249,2267168,5989641
Sierra Leone,2008,3083195,3050404,3817768,2347604,6133599
Sierra Leone,2009,3152169,3120566,3882977,2427283,6272735
Sierra Leone,2010,3223031,3192605,3949115,2509605,6415636
Sierra Leone,2011,3296278,3266960,4016739,2594953,6563238
Sierra Leone,2012,3370393,3342193,4083903,2682200,6712586
Sierra Leone,2013,3445504,3418471,4150770,2771308,6863975
Sierra Leone,2014,3521439,3495714,4216939,2862223,7017153
Sierra Leone,2015,3598060,3573849,4282234,2954791,7171909
Sierra Leone,2016,3675669,3653177,4346912,3049278,7328846
Sierra Leone,2017,3754502,3733925,4410710,3146502,7488427
Sierra Leone,2018,3834352,3815797,4473227,3246502,7650149
Singapore,2000,1962696,2066176,0,3913960,4028872
Singapore,2001,1991954,2085196,0,4018779,4077150
Singapore,2002,2014839,2089568,0,4131207,4104407
Singapore,2003,2037167,2092060,0,4249295,4129227
Singapore,2004,2066958,2110244,0,4370040,4177202
Singapore,2005,2109633,2156060,0,4491042,4265693
Singapore,2006,2167541,2234783,0,4611901,4402324
Singapore,2007,2238000,2340629,0,4732528,4578629
Singapore,2008,2314982,2460828,0,4851109,4775810
Singapore,2009,2389778,2576836,0,4965518,4966614
Singapore,2010,2456029,2675141,0,5074252,5131170
Singapore,2011,2511893,2751747,0,5176017,5263640
Singapore,2012,2559022,2810447,0,5270958,5369469
Singapore,2013,2598744,2854988,0,5360837,5453732
Singapore,2014,2633629,2891999,0,5448342,5525628
Singapore,2015,2665659,2926484,0,5535262,5592143
Singapore,2016,2694807,2958818,0,5622455,5653625
Singapore,2017,2720560,2987482,0,5708844,5708042
Singapore,2018,2743918,3013585,0,5791901,5757503
Slovakia,2000,2777535,2621672,2363059,3036152,5399207
Slovakia,2001,2778966,2621029,2367176,3032830,5399995
Slovakia,2002,2780026,2620098,2375345,3024809,5400124
Slovakia,2003,2780778,2619066,2383336,3016550,5399844
Slovakia,2004,2781247,2618127,2391255,3008164,5399374
Slovakia,2005,2781485,2617477,2399162,2999801,5398962
Slovakia,2006,2781520,2617154,2407098,2991443,5398674
Slovakia,2007,2781454,2617239,2415132,2983194,5398693
Slovakia,2008,2781501,2617861,2423516,2975340,5399362
Slovakia,2009,2781953,2619196,2432484,2968235,5401149
Slovakia,2010,2782960,2621333,2448958,2955336,5404293
Slovakia,2011,2784621,2624311,2465827,2944020,5408932
Slovakia,2012,2786860,2628034,2476704,2940366,5414894
Slovakia,2013,2789443,2632278,2487967,2937163,5421721
Slovakia,2014,2792038,2636760,2499107,2933734,5428798
Slovakia,2015,2794400,2641214,2508148,2931170,5435614
Slovakia,2016,2796424,2645577,2514920,2929298,5442001
Slovakia,2017,2798129,2649774,2519468,2928194,5447903
Slovakia,2018,2799488,2653529,2521863,2927953,5453017
Slovenia,2000,1015706,972004,979257,1009242,1987710
Slovenia,2001,1015358,972099,978660,1009689,1987457
Slovenia,2002,1015661,971604,977096,1011168,1987265
Slovenia,2003,1016549,971306,972957,1016008,1987855
Slovenia,2004,1017868,972358,969669,1021761,1990226
Slovenia,2005,1019485,975494,967539,1028742,1994979
Slovenia,2006,1021368,981059,966665,1037126,2002427
Slovenia,2007,1023523,988605,966833,1046705,2012128
Slovenia,2008,1025859,997189,967551,1056987,2023048
Slovenia,2009,1028330,1005476,968180,1067244,2033806
Slovenia,2010,1030855,1012481,968215,1076953,2043336
Slovenia,2011,1033402,1017876,967513,1085923,2051278
Slovenia,2012,1035926,1021899,966153,1094237,2057825
Slovenia,2013,1038281,1024839,964206,1101913,2063120
Slovenia,2014,1040320,1027166,961764,1109081,2067486
Slovenia,2015,1041948,1029251,958942,1115846,2071199
Slovenia,2016,1043085,1031119,955396,1122466,2074204
Slovenia,2017,1043752,1032642,951104,1128872,2076394
Slovenia,2018,1044012,1033823,946127,1135133,2077835
Solomon Islands,2000,200550,212115,347363,65245,412665
Solomon Islands,2001,206207,217742,355185,68668,423949
Solomon Islands,2002,212048,223386,363021,72241,435434
Solomon Islands,2003,217999,229017,370814,75955,447016
Solomon Islands,2004,223964,234585,378516,79808,458549
Solomon Islands,2005,229855,240063,386096,83789,469918
Solomon Islands,2006,235654,245432,393518,87904,481086
Solomon Islands,2007,241414,250719,400788,92152,492133
Solomon Islands,2008,247227,256139,407930,96547,503366
Solomon Islands,2009,253279,261903,414986,101093,515182
Solomon Islands,2010,259675,268186,421980,105810,527861
Solomon Islands,2011,266474,275048,428948,110666,541522
Solomon Islands,2012,273617,282449,435874,115657,556066
Solomon Islands,2013,281064,290265,442735,120778,571329
Solomon Islands,2014,288724,298355,449490,126014,587079
Solomon Islands,2015,296556,306577,456121,131361,603133
Solomon Islands,2016,304526,314912,462611,136808,619438
Solomon Islands,2017,312654,323376,468983,142360,636030
Solomon Islands,2018,320909,331947,475260,148021,652856
Somalia,2000,4429313,4442937,6015423,2996056,8872250
Somalia,2001,4587168,4599551,6167501,3123322,9186719
Somalia,2002,4745059,4756276,6313307,3250860,9501335
Somalia,2003,4902742,4912670,6417677,3418720,9815412
Somalia,2004,5060984,5069267,6521864,3594364,10130251
Somalia,2005,5220385,5226471,6629975,3779950,10446856
Somalia,2006,5380307,5383597,6741849,3976468,10763904
Somalia,2007,5540083,5540039,7240839,3797757,11080122
Somalia,2008,5700490,5696698,7275093,4094183,11397188
Somalia,2009,5862723,5854968,7300523,4407467,11717691
Somalia,2010,6027843,6016043,7315117,4738106,12043886
Somalia,2011,6196100,6180205,7318788,5085937,12376305
Somalia,2012,6367763,6347724,7459376,5304400,12715487
Somalia,2013,6543908,6519803,7601384,5530965,13063711
Somalia,2014,6725759,6697812,7745889,5767236,13423571
Somalia,2015,6914348,6882856,7893535,6014594,13797204
Somalia,2016,7110142,7075493,8044409,6273587,14185635
Somalia,2017,7313307,7275858,8198119,6544404,14589165
Somalia,2018,7524126,7484099,8354510,6827415,15008225
South Africa,2000,22796107,22171606,19713179,26015136,44967713
South Africa,2001,23103252,22468020,19774867,26610139,45571272
South Africa,2002,23397962,22752951,19799101,27227072,46150913
South Africa,2003,23686434,23032769,19800023,27848704,46719203
South Africa,2004,23976130,23315480,19784966,28462429,47291610
South Africa,2005,24273136,23607459,19754866,29065720,47880595
South Africa,2006,24579340,23910124,19707664,29656918,48489464
South Africa,2007,24895876,24223890,19647368,30239813,49119766
South Africa,2008,25226850,24552622,19583275,30828854,49779472
South Africa,2009,25576554,24900459,19528590,31442228,50477013
South Africa,2010,25947466,25269501,19489852,32094811,51216967
South Africa,2011,26341727,25662032,19470335,32793180,52003759
South Africa,2012,26757264,26075395,19465377,33532836,52832659
South Africa,2013,27186808,26500317,19467489,34299907,53687125
South Africa,2014,27620134,26924050,19463910,35075661,54544184
South Africa,2015,28049365,27337004,19446876,35844349,55386369
South Africa,2016,28471936,27735713,19414491,36600982,56207649
South Africa,2017,28888314,28121437,19369002,37348154,57009751
South Africa,2018,29297427,28495093,19311652,38086769,57792520
South Sudan,2012,5056517,5057131,8847540,1970718,10113648
South Sudan,2013,5176380,5178650,9119185,2058304,10355030
South Sudan,2014,5275534,5279348,9383162,2147809,10554882
South Sudan,2015,5355171,5360486,9642116,2240020,10715657
South Sudan,2016,5412867,5419653,9895674,2335056,10832520
South Sudan,2017,5451281,5459493,10142827,2432887,10910774
South Sudan,2018,5483166,5492758,10384989,2534064,10975924
Spain,2000,20783585,20041160,9709605,31194106,40824745
Spain,2001,21016357,20303074,9792190,31599913,41319431
Spain,2002,21300575,20619018,9852597,32132923,41919593
Spain,2003,21622612,20973843,9904876,32748530,42596455
Spain,2004,21962559,21345786,9961494,33390174,43308345
Spain,2005,22303276,21715842,10014136,34028496,44019118
Spain,2006,22644101,22084460,10062286,34663246,44728561
Spain,2007,22981704,22447367,10104737,35289121,45429071
Spain,2008,23293236,22775575,10130511,35867295,46068811
Spain,2009,23550557,23033009,10127186,36348886,46583566
Spain,2010,23734878,23196133,10086595,36702035,46931011
Spain,2011,23834599,23249643,10004441,36904697,47084242
Spain,2012,23857591,23205468,9886091,36971313,47063059
Spain,2013,23829129,23101425,9744548,36953005,46930554
Spain,2014,23786099,22991828,9599224,36922603,46777927
Spain,2015,23755678,22916241,9464206,36933458,46671919
Spain,2016,23746305,22887826,9343737,37003839,46634131
Spain,2017,23751411,22896014,9233918,37120403,46647425
Spain,2018,23765099,22927764,9130380,37267072,46692863
Sri Lanka,2000,9411667,9365939,15329767,3452171,18777606
Sri Lanka,2001,9497429,9414298,15439700,3473354,18911727
Sri Lanka,2002,9593655,9468821,15562028,3497272,19062476
Sri Lanka,2003,9697099,9526937,15692371,3522936,19224036
Sri Lanka,2004,9802666,9584487,15823764,3548774,19387153
Sri Lanka,2005,9906511,9638477,15950938,3573620,19544988
Sri Lanka,2006,10007678,9688299,16072910,3597241,19695977
Sri Lanka,2007,10106989,9735055,16190874,3619915,19842044
Sri Lanka,2008,10204466,9779518,16304311,3641521,19983984
Sri Lanka,2009,10300547,9822961,16413044,3662041,20123508
Sri Lanka,2010,10395425,9866313,16516926,3681427,20261738
Sri Lanka,2011,10488913,9909583,16615442,3699575,20398496
Sri Lanka,2012,10580222,9952377,16708167,3716388,20532599
Sri Lanka,2013,10668353,9994700,16791684,3735549,20663053
Sri Lanka,2014,10752025,10036487,16866370,3757194,20788512
Sri Lanka,2015,10830362,10077662,16932569,3781471,20908024
Sri Lanka,2016,10902883,10118294,16990083,3808409,21021177
Sri Lanka,2017,10969813,10158215,17038849,3838068,21128028
Sri Lanka,2018,11031911,10196849,17079399,3870642,21228760
Sudan,2012,18140461,18053320,23988926,12001266,36193781
Sudan,2013,18574540,18498015,24502709,12347209,37072555
Sudan,2014,19020771,18956886,25024231,12713682,37977657
Sudan,2015,19478321,19424627,25548489,13099314,38902948
Sudan,2016,19947203,19900230,26074189,13504639,39847433
Sudan,2017,20427932,20385466,26602042,13931288,40813398
Sudan,2018,20920586,20880946,27131309,14380217,41801532
Suriname,2000,233059,237885,158514,313876,470944
Suriname,2001,235987,240587,159960,317780,476574
Suriname,2002,238872,243356,161381,321663,482228
Suriname,2003,241751,246187,162790,325542,487938
Suriname,2004,244623,249057,164195,329435,493680
Suriname,2005,247540,251921,166238,332708,499461
Suriname,2006,250494,254798,168365,335942,505292
Suriname,2007,253479,257702,170511,339194,511181
Suriname,2008,256505,260617,172681,342467,517122
Suriname,2009,259553,263560,174867,345752,523113
Suriname,2010,262604,266522,177066,349037,529126
Suriname,2011,265677,269500,179273,352316,535177
Suriname,2012,268755,272492,181489,355588,541247
Suriname,2013,271823,275472,183704,358836,547295
Suriname,2014,274853,278425,185806,362122,553278
Suriname,2015,277821,281315,187781,365427,559136
Suriname,2016,280733,284150,189623,368745,564883
Suriname,2017,283583,286918,191326,372076,570501
Suriname,2018,286364,289623,192884,375417,575987
Sweden,2000,4489380,4392262,1418749,7462891,8881642
Sweden,2001,4495901,4401901,1417317,7480476,8897802
Sweden,2002,4505475,4415228,1415408,7505286,8920703
Sweden,2003,4518610,4432829,1414725,7536697,8951439
Sweden,2004,4535589,4455064,1415350,7575289,8990653
Sweden,2005,4556537,4482090,1417334,7621289,9038627
Sweden,2006,4581833,4514337,1416324,7679940,9096170
Sweden,2007,4611383,4551558,1412213,7751030,9162941
Sweden,2008,4644085,4592348,1409010,7827880,9236433
Sweden,2009,4678352,4634733,1406182,7907296,9313085
Sweden,2010,4712987,4677170,1403234,7986934,9390157
Sweden,2011,4747571,4719134,1391807,8074085,9466705
Sweden,2012,4782143,4760674,1371997,8168910,9542817
Sweden,2013,4816485,4801531,1352261,8262986,9618016
Sweden,2014,4850507,4841630,1332551,8356825,9692137
Sweden,2015,4884093,4880856,1312954,8450611,9764949
Sweden,2016,4917041,4918962,1293399,8544134,9836003
Sweden,2017,4949163,4955732,1273943,8636758,9904895
Sweden,2018,4980408,4991222,1254718,8727991,9971630
Switzerland,2000,3653446,3490318,1907695,5259555,7143764
Switzerland,2001,3670966,3508208,1917728,5284957,7179174
Switzerland,2002,3691273,3529105,1926831,5317083,7220378
Switzerland,2003,3714665,3553698,1937708,5354185,7268363
Switzerland,2004,3741184,3582544,1950516,5396731,7323728
Switzerland,2005,3770818,3616000,1965346,5444962,7386818
Switzerland,2006,3803677,3654284,1982272,5499135,7457961
Switzerland,2007,3839788,3697198,2001241,5559117,7536986
Switzerland,2008,3878810,3744016,2021967,5624146,7622826
Switzerland,2009,3920287,3793615,2044053,5693108,7713902
Switzerland,2010,3963678,3844996,2067083,5764887,7808674
Switzerland,2011,4008966,3898022,2091187,5839234,7906988
Switzerland,2012,4055725,3952281,2116141,5915529,8008006
Switzerland,2013,4102639,4006237,2140993,5991681,8108876
Switzerland,2014,4148006,4057997,2164734,6064895,8206003
Switzerland,2015,4190586,4106189,2186643,6133126,8296775
Switzerland,2016,4229812,4150103,2206365,6195374,8379915
Switzerland,2017,4265865,4189932,2224037,6251968,8455797
Switzerland,2018,4299222,4226392,2238762,6305272,8525614
Syrian Arab Republic,2000,8109037,8301809,7885963,8524885,16410846
Syrian Arab Republic,2001,8269361,8497193,7995447,8771452,16766554
Syrian Arab Republic,2002,8404990,8679638,8085687,9002214,17084628
Syrian Arab Republic,2003,8545955,8869259,8176604,9238662,17415214
Syrian Arab Republic,2004,8733895,9093932,8294901,9511737,17827827
Syrian Arab Republic,2005,8992895,9368283,8455456,9839155,18361178
Syrian Arab Republic,2006,9347043,9712214,8673211,10241766,19059257
Syrian Arab Republic,2007,9772452,10105805,8930863,10701943,19878257
Syrian Arab Republic,2008,10187741,10476296,9171916,11153527,20664037
Syrian Arab Republic,2009,10481159,10724714,9321767,11503126,21205873
Syrian Arab Republic,2010,10577491,10785050,9332362,11686472,21362541
Syrian Arab Republic,2011,10449087,10632727,9476439,11387554,21081814
Syrian Arab Republic,2012,10134980,10303881,9484477,10936224,20438861
Syrian Arab Republic,2013,9709439,9869027,9403582,10405559,19578466
Syrian Arab Republic,2014,9280573,9430138,9313499,9889591,18710711
Syrian Arab Republic,2015,8931433,9065978,8961409,9773578,17997411
Syrian Arab Republic,2016,8675964,8789603,8692690,9737763,17465567
Syrian Arab Republic,2017,8503336,8592333,8495489,9774379,17095669
Syrian Arab Republic,2018,8441049,8504013,8381170,9903237,16945062
Tajikistan,2000,3102606,3113723,4568853,1647352,6216329
Tajikistan,2001,3151363,3167147,4650260,1676865,6318510
Tajikistan,2002,3203159,3223702,4738751,1708937,6426861
Tajikistan,2003,3258005,3283545,4833576,1743301,6541550
Tajikistan,2004,3315715,3346676,4933375,1779466,6662391
Tajikistan,2005,3376232,3413086,5037117,1817059,6789318
Tajikistan,2006,3439626,3482964,5144561,1855996,6922590
Tajikistan,2007,3506200,3556467,5256003,1896382,7062667
Tajikistan,2008,3576388,3633536,5371491,1938237,7209924
Tajikistan,2009,3650719,3714033,5491198,1981621,7364752
Tajikistan,2010,3729559,3797838,5615102,2026528,7527397
Tajikistan,2011,3812811,3884696,5743046,2072902,7697507
Tajikistan,2012,3900294,3974544,5872805,2122257,7874838
Tajikistan,2013,3992093,4067689,6003406,2174403,8059782
Tajikistan,2014,4088264,4164564,6133662,2229083,8252828
Tajikistan,2015,4188683,4265336,6262550,2286101,8454019
Tajikistan,2016,4293442,4370133,6389516,2345435,8663575
Tajikistan,2017,4401952,4478318,6514203,2407140,8880270
Tajikistan,2018,4512549,4588298,6636026,2471185,9100847
Thailand,2000,31858179,31094460,43198106,19759915,62952639
Thailand,2001,32187719,31351471,42861156,20682166,63539190
Thailand,2002,32484850,31584243,42458762,21614402,64069093
Thailand,2003,32754202,31795665,41999085,22555867,64549867
Thailand,2004,33004500,31990802,41491898,23510333,64995302
Thailand,2005,33242497,32173692,40948938,24476532,65416189
Thailand,2006,33468091,32344449,40368169,25455995,65812540
Thailand,2007,33679474,32502590,39750794,26444821,66182064
Thailand,2008,33880021,32650959,39101036,27444724,66530980
Thailand,2009,34073804,32793030,38428419,28453448,66866834
Thailand,2010,34263753,32931279,37733694,29475114,67195032
Thailand,2011,34451327,33067052,37345660,30184470,67518379
Thailand,2012,34636105,33199864,37012171,30831808,67835969
Thailand,2013,34816557,33327962,36666051,31477014,68144519
Thailand,2014,34990213,33448535,36300112,32116660,68438748
Thailand,2015,35155051,33559468,35911920,32745680,68714519
Thailand,2016,35310912,33660401,35500674,33362839,68971313
Thailand,2017,35457991,33751826,35071057,33966456,69209817
Thailand,2018,35595069,33833385,34627095,34556078,69428454
Timor-Leste,2000,437591,446775,660127,211480,884366
Timor-Leste,2001,445912,455302,672797,219734,901214
Timor-Leste,2002,456577,466122,693062,230763,922699
Timor-Leste,2003,468719,478391,717348,243504,947110
Timor-Leste,2004,481020,490869,740448,256250,971889
Timor-Leste,2005,492521,502609,759180,267304,995130
Timor-Leste,2006,503018,513419,772061,276560,1016437
Timor-Leste,2007,512801,523587,780526,284447,1036388
Timor-Leste,2008,522113,533315,786501,291609,1055428
Timor-Leste,2009,531343,542943,792930,299091,1074286
Timor-Leste,2010,540775,552742,801874,307717,1093517
Timor-Leste,2011,550445,562709,813805,317718,1113154
Timor-Leste,2012,560232,572770,827913,328847,1133002
Timor-Leste,2013,570259,583029,843513,340853,1153288
Timor-Leste,2014,580675,593658,859479,353335,1174333
Timor-Leste,2015,591555,604739,875011,365966,1196294
Timor-Leste,2016,602951,616338,889974,378697,1219289
Timor-Leste,2017,614851,628409,904669,391642,1243260
Timor-Leste,2018,627121,640854,919214,404880,1267975
Togo,2000,2492569,2431837,3334778,1635589,4924406
Togo,2001,2561204,2501367,3406691,1705079,5062571
Togo,2002,2628235,2568805,3476016,1775456,5197040
Togo,2003,2694959,2635670,3544063,1847338,5330629
Togo,2004,2763371,2704399,3612772,1921826,5467770
Togo,2005,2834944,2776699,3683622,1999646,5611643
Togo,2006,2909941,2852940,3756669,2081123,5762881
Togo,2007,2987877,2932483,3831357,2166028,5920360
Togo,2008,3068509,3014908,3907407,2254389,6083417
Togo,2009,3151362,3099478,3984514,2345958,6250840
Togo,2010,3236041,3185633,4062203,2440749,6421674
Togo,2011,3322594,3273345,4139026,2540256,6595939
Togo,2012,3411071,3362736,4215435,2644047,6773807
Togo,2013,3501143,3453578,4291901,2751047,6954721
Togo,2014,3592387,3545610,4367759,2861156,7137997
Togo,2015,3684504,3638658,4442664,2974138,7323162
Togo,2016,3777354,3732598,4516059,3090315,7509952
Togo,2017,3871015,3827461,4588034,3209660,7698476
Togo,2018,3965694,3923401,4658578,3332348,7889095
Tonga,2000,48100,49862,75511,22571,97962
Tonga,2001,48447,50035,75890,22721,98482
Tonga,2002,48871,50152,76303,22881,99023
Tonga,2003,49327,50264,76740,23049,99591
Tonga,2004,49791,50423,77185,23221,100214
Tonga,2005,50256,50652,77645,23396,100908
Tonga,2006,50722,50992,78113,23576,101714
Tonga,2007,51170,51407,78582,23775,102577
Tonga,2008,51561,51823,79024,23981,103384
Tonga,2009,51807,52090,79428,24176,103897
Tonga,2010,51851,52130,79780,24357,103981
Tonga,2011,51659,51899,80061,24516,103558
Tonga,2012,51287,51449,80356,24595,102736
Tonga,2013,50843,50925,80701,24627,101768
Tonga,2014,50505,50518,81105,24677,101023
Tonga,2015,50407,50373,81608,24756,100780
Tonga,2016,50589,50554,82246,24876,101143
Tonga,2017,51005,50997,82993,25027,102002
Tonga,2018,51586,51613,83793,25215,103199
Trinidad and Tobago,2000,636416,630743,559116,708868,1267159
Trinidad and Tobago,2001,639007,632620,563436,708944,1271627
Trinidad and Tobago,2002,642242,634968,568249,709588,1277210
Trinidad and Tobago,2003,645905,637659,573423,710629,1283564
Trinidad and Tobago,2004,649650,640465,578746,711789,1290115
Trinidad and Tobago,2005,653253,643244,584051,712883,1296497
Trinidad and Tobago,2006,656627,645925,589300,713844,1302552
Trinidad and Tobago,2007,659859,648591,594531,714729,1308450
Trinidad and Tobago,2008,663099,651350,599788,715584,1314449
Trinidad and Tobago,2009,666555,654366,605125,716493,1320921
Trinidad and Tobago,2010,670386,657758,610599,717501,1328144
Trinidad and Tobago,2011,674629,661551,616193,718595,1336180
Trinidad and Tobago,2012,679168,665646,621549,720039,1344814
Trinidad and Tobago,2013,683835,669873,626536,721712,1353708
Trinidad and Tobago,2014,688380,673957,631023,723470,1362337
Trinidad and Tobago,2015,692615,677717,634898,725194,1370332
Trinidad and Tobago,2016,696476,681087,638115,726847,1377563
Trinidad and Tobago,2017,699979,684081,640679,728446,1384060
Trinidad and Tobago,2018,703139,686702,642593,730005,1389841
Tunisia,2000,4819179,4889168,3546812,6152385,9708347
Tunisia,2001,4867308,4926607,3540690,6245011,9793915
Tunisia,2002,4912232,4959029,3531202,6333124,9871261
Tunisia,2003,4955877,4989405,3520132,6419546,9945282
Tunisia,2004,5000690,5021588,3511132,6506469,10022278
Tunisia,2005,5048475,5058303,3511889,6590593,10106778
Tunisia,2006,5100084,5101127,3515255,6680881,10201211
Tunisia,2007,5155243,5149486,3521038,6777049,10304729
Tunisia,2008,5213159,5201266,3528791,6878545,10414425
Tunisia,2009,5272483,5253208,3537891,6983943,10525691
Tunisia,2010,5332212,5303033,3547627,7092304,10635245
Tunisia,2011,5392038,5349834,3557963,7203504,10741872
Tunisia,2012,5452270,5394723,3568906,7317762,10846993
Tunisia,2013,5513159,5439790,3580242,7434316,10952949
Tunisia,2014,5575111,5488084,3591431,7552477,11063195
Tunisia,2015,5638325,5541626,3601278,7672383,11179951
Tunisia,2016,5702821,5601121,3609591,7793657,11303942
Tunisia,2017,5768086,5665352,3616197,7915930,11433438
Tunisia,2018,5833159,5732044,3620748,8038426,11565203
Turkey,2000,32096148,31144048,22297793,40942328,63240196
Turkey,2001,32583788,31608455,22248580,41942894,64192243
Turkey,2002,33071044,32074313,22165676,42977378,65145357
Turkey,2003,33553500,32535902,22071506,44014297,66089402
Turkey,2004,34025331,32985599,21962050,45045805,67010930
Turkey,2005,34483857,33419604,21837813,46065593,67903461
Turkey,2006,34924109,33832700,21694980,47068425,68756809
Turkey,2007,35351055,34230799,21537953,48059328,69581854
Turkey,2008,35783887,34634725,21377504,49062528,70418612
Turkey,2009,36248632,35072774,21229600,50109585,71321406
Turkey,2010,36762746,35564246,21101166,51225748,72326992
Turkey,2011,37330533,36112721,20993291,52416164,73443254
Turkey,2012,37942454,36708592,20899302,53670565,74651046
Turkey,2013,38584479,37340975,20818043,54969290,75925454
Turkey,2014,39235978,37993284,20738821,56291807,77229262
Turkey,2015,39879351,38650062,20654742,57616730,78529413
Turkey,2016,40514350,39313518,20566910,58945516,79827868
Turkey,2017,41138240,39978211,20473563,60271457,81116451
Turkey,2018,41728157,40611933,20362183,61554688,82340090
Turkmenistan,2000,2293296,2222832,2442622,2073509,4516128
Turkmenistan,2001,2317935,2246152,2458330,2105750,4564087
Turkmenistan,2002,2341554,2268464,2472713,2137289,4610018
Turkmenistan,2003,2365064,2290688,2486786,2168955,4655752
Turkmenistan,2004,2389522,2313874,2501652,2201746,4703396
Turkmenistan,2005,2415764,2338888,2517482,2237159,4754652
Turkmenistan,2006,2444100,2366014,2534518,2275587,4810114
Turkmenistan,2007,2474709,2395433,2552898,2317239,4870142
Turkmenistan,2008,2508075,2427690,2573093,2362669,4935765
Turkmenistan,2009,2544660,2463293,2595530,2412420,5007953
Turkmenistan,2010,2584697,2502514,2620378,2466832,5087211
Turkmenistan,2011,2628449,2545627,2647803,2526258,5174076
Turkmenistan,2012,2675610,2592296,2677355,2590484,5267906
Turkmenistan,2013,2725077,2641299,2707779,2658498,5366376
Turkmenistan,2014,2775337,2690987,2737414,2728827,5466324
Turkmenistan,2015,2825213,2740070,2764990,2800294,5565283
Turkmenistan,2016,2874284,2788087,2790057,2872487,5662371
Turkmenistan,2017,2922583,2835084,2812629,2945446,5757667
Turkmenistan,2018,2969961,2880941,2832499,3018967,5850902
Uganda,2000,12007349,11642810,20484903,3554371,23650159
Uganda,2001,12381575,12007399,21076726,3778166,24388974
Uganda,2002,12772573,12394688,21699290,4018758,25167261
Uganda,2003,13180488,12800059,22348557,4276263,25980547
Uganda,2004,13604894,13216406,23017847,4550589,26821300
Uganda,2005,14045554,13639036,23702764,4841176,27684590
Uganda,2006,14503938,14067537,24401496,5149166,28571475
Uganda,2007,14981114,14505221,25115006,5475481,29486335
Uganda,2008,15476024,14955710,25842671,5821225,30431734
Uganda,2009,15986976,15424120,26585117,6186778,31411096
Uganda,2010,16513345,15914819,27341361,6573772,32428164
Uganda,2011,17051388,16425383,28110753,6982895,33476771
Uganda,2012,17602608,16956092,28891600,7415196,34558700
Uganda,2013,18177539,17516980,29683100,7870626,35694519
Uganda,2014,18790443,18121087,30482665,8350673,36911530
Uganda,2015,19449739,18775708,31289039,8855831,38225447
Uganda,2016,20161759,19487414,32101656,9386309,39649173
Uganda,2017,20918416,20248172,32920646,9942312,41166588
Uganda,2018,21696127,21032905,33745480,10525083,42729032
Ukraine,2000,26104402,22733656,16046507,32793567,48838058
Ukraine,2001,25883849,22517799,15884189,32518696,48401648
Ukraine,2002,25671778,22308255,15697688,32281904,47980033
Ukraine,2003,25473819,22108644,15498315,32082244,47582463
Ukraine,2004,25295612,21921877,15299601,31916365,47217489
Ukraine,2005,25140669,21750106,15103966,31788197,46890775
Ukraine,2006,25012305,21595092,14931773,31684616,46607397
Ukraine,2007,24908835,21457512,14775381,31610974,46366347
Ukraine,2008,24822177,21336532,14629477,31556953,46158709
Ukraine,2009,24740617,21230325,14487124,31506900,45970942
Ukraine,2010,24655270,21136816,14380838,31411663,45792086
Ukraine,2011,24563508,21056342,14270405,31305902,45619850
Ukraine,2012,24466401,20987404,14157020,31192313,45453805
Ukraine,2013,24363237,20923751,14042196,31073589,45286988
Ukraine,2014,24254262,20857268,13928187,30955239,45111530
Ukraine,2015,24139672,20781964,13816730,30840974,44921636
Ukraine,2016,24018470,20695238,13707753,30730872,44713708
Ukraine,2017,23889867,20597841,13600408,30622539,44487708
Ukraine,2018,23754767,20491391,13487744,30521470,44246158
United Arab Emirates,2000,1016932,2117135,623527,2531398,3134067
United Arab Emirates,2001,1063983,2238739,643432,2682600,3302722
United Arab Emirates,2002,1113817,2364952,664034,2843198,3478769
United Arab Emirates,2003,1173726,2538205,693304,3048628,3711931
United Arab Emirates,2004,1253344,2815233,741096,3346835,4068577
United Arab Emirates,2005,1358723,3229499,812302,3767260,4588222
United Arab Emirates,2006,1492804,3807368,909617,4332415,5300172
United Arab Emirates,2007,1651188,4517658,1026131,5017936,6168846
United Arab Emirates,2008,1823380,5266106,1145328,5748950,7089486
United Arab Emirates,2009,1994691,5922677,1246392,6420001,7917368
United Arab Emirates,2010,2154032,6395966,1316091,6954593,8549998
United Arab Emirates,2011,2298030,6648748,1350919,7321556,8946778
United Arab Emirates,2012,2428283,6713315,1357387,7543066,9141598
United Arab Emirates,2013,2544751,6653157,1344955,7661308,9197908
United Arab Emirates,2014,2648905,6565277,1326639,7744228,9214182
United Arab Emirates,2015,2742042,6520854,1311419,7842883,9262896
United Arab Emirates,2016,2823141,6537834,1300961,7968651,9360975
United Arab Emirates,2017,2891724,6595482,1292709,8107436,9487206
United Arab Emirates,2018,2950609,6680357,1285972,8255643,9630966
United Kingdom of Great Britain and Northern Ireland,2000,30211741,28711564,12585414,46365434,58923305
United Kingdom of Great Britain and Northern Ireland,2001,30290673,28833604,12568459,46580884,59124277
United Kingdom of Great Britain and Northern Ireland,2002,30366072,28960222,12435493,46913460,59326294
United Kingdom of Great Britain and Northern Ireland,2003,30456192,29105237,12309693,47270529,59561429
United Kingdom of Great Britain and Northern Ireland,2004,30585658,29287102,12198913,47685215,59872760
United Kingdom of Great Britain and Northern Ireland,2005,30770468,29517485,12108499,48178255,60287953
United Kingdom of Great Britain and Northern Ireland,2006,31018774,29802575,12039836,48762965,60821349
United Kingdom of Great Britain and Northern Ireland,2007,31321021,30134133,11988805,49425855,61455154
United Kingdom of Great Britain and Northern Ireland,2008,31653595,30491503,11945543,50130678,62145098
United Kingdom of Great Britain and Northern Ireland,2009,31982959,30845661,11898094,50824513,62828620
United Kingdom of Great Britain and Northern Ireland,2010,32284521,31175280,11837146,51469697,63459801
United Kingdom of Great Britain and Northern Ireland,2011,32549494,31472428,11760347,52051535,64021922
United Kingdom of Great Britain and Northern Ireland,2012,32783674,31741626,11669597,52580733,64525300
United Kingdom of Great Britain and Northern Ireland,2013,32994836,31989179,11569344,53071766,64984015
United Kingdom of Great Britain and Northern Ireland,2014,33196604,32226444,11465340,53550346,65423048
United Kingdom of Great Britain and Northern Ireland,2015,33398650,32461498,11361769,54035311,65860148
United Kingdom of Great Britain and Northern Ireland,2016,33602517,32695427,11259199,54529375,66297944
United Kingdom of Great Britain and Northern Ireland,2017,33803381,32924082,11156164,55025421,66727463
United Kingdom of Great Britain and Northern Ireland,2018,33997373,33144305,11052278,55521226,67141678
United Republic of Tanzania,2000,16838006,16661170,26553317,7624725,33499176
United Republic of Tanzania,2001,17283163,17102686,27154582,7962437,34385849
United Republic of Tanzania,2002,17758831,17575959,27785622,8320186,35334790
United Republic of Tanzania,2003,18260492,18077286,28377799,8771273,36337778
United Republic of Tanzania,2004,18780108,18599658,28984506,9265478,37379766
United Republic of Tanzania,2005,19312186,19138137,29619018,9791527,38450323
United Republic of Tanzania,2006,19856009,19692657,30282031,10352917,39548666
United Republic of Tanzania,2007,20415193,20266223,30972693,10951022,40681416
United Republic of Tanzania,2008,20993496,20860448,31684102,11586042,41853944
United Republic of Tanzania,2009,21596200,21477630,32408679,12255552,43073830
United Republic of Tanzania,2010,22227068,22119464,33138622,12959969,44346532
United Republic of Tanzania,2011,22887321,22786199,33871494,13699408,45673520
United Republic of Tanzania,2012,23575682,23477351,34606978,14476019,47053033
United Republic of Tanzania,2013,24290238,24192894,35346511,15290084,48483132
United Republic of Tanzania,2014,25027953,24932610,36092092,16142777,49960563
United Republic of Tanzania,2015,25786500,25696138,36844744,17035213,51482638
United Republic of Tanzania,2016,26565525,26483706,37603765,17968436,53049231
United Republic of Tanzania,2017,27365425,27294920,38367191,18942828,54660345
United Republic of Tanzania,2018,28185448,28127996,39132847,19958545,56313444
United States of America,2000,142949326,138761588,59054865,222927913,281710914
United States of America,2001,144358037,140249955,59153827,225698564,284607992
United States of America,2002,145654766,141624546,59200835,228306012,287279312
United States of America,2003,146887185,142928382,59214430,230813194,289815567
United States of America,2004,148127314,144227349,59219920,233319404,292354663
United States of America,2005,149425428,145568081,59237094,235892407,294993509
United States of America,2006,150796748,146962229,59269355,238558001,297758977
United States of America,2007,152218441,148389984,59309491,241285684,300608425
United States of America,2008,153657128,149828894,59345012,244029055,303486022
United States of America,2009,155063145,151244420,59361054,246715308,306307565
United States of America,2010,156400559,152610910,59344315,249297076,309011469
United States of America,2011,157660294,153923757,59275426,251775947,311584051
United States of America,2012,158854090,155189795,59160759,254174664,314043885
United States of America,2013,159992034,156408505,59009166,256527510,316400539
United States of America,2014,161091561,157581861,58833036,258885743,318673422
United States of America,2015,162166191,158712121,58641351,261287811,320878312
United States of America,2016,163217761,159798231,58436293,263743311,323015992
United States of America,2017,164243815,160840943,58215947,266243516,325084758
United States of America,2018,165249080,161847183,57980034,268786714,327096263
Uruguay,2000,1713076,1606658,264771,3056474,3319734
Uruguay,2001,1716910,1608561,256089,3071013,3325471
Uruguay,2002,1718306,1607740,247270,3080503,3326046
Uruguay,2003,1718279,1605382,238529,3087108,3323661
Uruguay,2004,1718302,1603184,230105,3093991,3321486
Uruguay,2005,1719395,1602404,222183,3103429,3321799
Uruguay,2006,1721948,1603455,214756,3116287,3325403
Uruguay,2007,1725707,1606046,207762,3131979,3331753
Uruguay,2008,1730363,1609858,201110,3149714,3340221
Uruguay,2009,1735393,1614283,194722,3168033,3349676
Uruguay,2010,1740387,1618886,188495,3185920,3359273
Uruguay,2011,1745315,1623611,182426,3203198,3368926
Uruguay,2012,1750324,1628651,178688,3218089,3378975
Uruguay,2013,1755455,1633981,175741,3232264,3389436
Uruguay,2014,1760783,1639656,172847,3246699,3400439
Uruguay,2015,1766341,1645672,170019,3261533,3412013
Uruguay,2016,1772136,1652003,167249,3276757,3424139
Uruguay,2017,1778065,1658580,164541,3292209,3436645
Uruguay,2018,1784026,1665264,161889,3307662,3449290
Uzbekistan,2000,12452947,12317008,13387219,11461701,24769955
Uzbekistan,2001,12625819,12482735,13449101,11739426,25108554
Uzbekistan,2002,12790892,12640224,13498784,12013092,25431116
Uzbekistan,2003,12953439,12795670,13542816,12287843,25749109
Uzbekistan,2004,13120524,12957090,13589132,12571194,26077614
Uzbekistan,2005,13297349,13130436,13643936,12868248,26427785
Uzbekistan,2006,13485912,13318155,13708459,13181804,26804067
Uzbekistan,2007,13685371,13519340,13781409,13510966,27204711
Uzbekistan,2008,13894597,13732384,13860930,13854895,27626981
Uzbekistan,2009,14111309,13954160,13944661,14210645,28065469
Uzbekistan,2010,14333699,14182209,14029623,14576671,28515908
Uzbekistan,2011,14561221,14415785,14199705,14868519,28977006
Uzbekistan,2012,14794148,14655267,14460143,15080676,29449415
Uzbekistan,2013,15032223,14900407,14724547,15295187,29932630
Uzbekistan,2014,15275273,15151121,14990427,15509191,30426394
Uzbekistan,2015,15522723,15406833,15255556,15720465,30929556
Uzbekistan,2016,15774421,15667332,15518905,15927890,31441753
Uzbekistan,2017,16028887,15930887,15779684,16130957,31959774
Uzbekistan,2018,16282725,16193507,16027774,16337222,32476232
Vanuatu,2000,90360,94604,144954,40109,184964
Vanuatu,2001,92483,96726,147736,41554,189209
Vanuatu,2002,94826,99101,150829,43127,193927
Vanuatu,2003,97334,101626,154156,44808,198960
Vanuatu,2004,99915,104208,157581,46562,204123
Vanuatu,2005,102520,106762,161008,48362,209282
Vanuatu,2006,105118,109261,164428,50206,214379
Vanuatu,2007,107736,111728,167853,52100,219464
Vanuatu,2008,110427,114273,171291,54049,224700
Vanuatu,2009,113262,116982,174737,56048,230244
Vanuatu,2010,116283,119933,178493,57802,236216
Vanuatu,2011,119503,123155,182465,59406,242658
Vanuatu,2012,122893,126612,186453,61032,249505
Vanuatu,2013,126409,130228,190463,62679,256637
Vanuatu,2014,129979,133908,194498,64352,263887
Vanuatu,2015,133555,137573,198555,66048,271128
Vanuatu,2016,137121,141205,202634,67768,278326
Vanuatu,2017,140686,144813,206733,69511,285499
Vanuatu,2018,144256,148419,210816,71301,292675
Venezuela (Bolivarian Republic of),2000,12052838,12139611,3046475,21441865,24192449
Venezuela (Bolivarian Republic of),2001,12284824,12361647,3031240,21917236,24646471
Venezuela (Bolivarian Republic of),2002,12517096,12583311,3080534,22328166,25100407
Venezuela (Bolivarian Republic of),2003,12748443,12803181,3129553,22738970,25551624
Venezuela (Bolivarian Republic of),2004,12977216,13019378,3178200,23149025,25996594
Venezuela (Bolivarian Republic of),2005,13202089,13230356,3226428,23557733,26432445
Venezuela (Bolivarian Republic of),2006,13418808,13431382,3274191,23964977,26850190
Venezuela (Bolivarian Republic of),2007,13626270,13621331,3321466,24370499,27247601
Venezuela (Bolivarian Republic of),2008,13829691,13806136,3368145,24773556,27635827
Venezuela (Bolivarian Republic of),2009,14036614,13994396,3414135,25173188,28031010
Venezuela (Bolivarian Republic of),2010,14250186,14189756,3459313,25568720,28439942
Venezuela (Bolivarian Republic of),2011,14482251,14405622,3503631,25959660,28887873
Venezuela (Bolivarian Republic of),2012,14726158,14634669,3550466,26342614,29360827
Venezuela (Bolivarian Republic of),2013,14945203,14835843,3597718,26720130,29781046
Venezuela (Bolivarian Republic of),2014,15089558,14953415,3644375,27094003,30042973
Venezuela (Bolivarian Republic of),2015,15128613,14953214,3690499,27464635,30081827
Venezuela (Bolivarian Republic of),2016,15040542,14810707,3736094,27832085,29851249
Venezuela (Bolivarian Republic of),2017,14849444,14553036,3778814,28198251,29402480
Venezuela (Bolivarian Republic of),2018,14626489,14260628,3818502,28562719,28887117
Viet Nam,2000,40339929,39570482,60716972,19568590,79910411
Viet Nam,2001,40761946,39980554,60905689,20234230,80742500
Viet Nam,2002,41163645,40370761,61048895,20907601,81534406
Viet Nam,2003,41550237,40751413,61156846,21590816,82301650
Viet Nam,2004,41927658,41135161,61239621,22288057,83062819
Viet Nam,2005,42301134,41531528,61308288,23000555,83832662
Viet Nam,2006,42672673,41944872,61363160,23731457,84617545
Viet Nam,2007,43044661,42374927,61408016,24481574,85419588
Viet Nam,2008,43422822,42820602,61451799,25256002,86243424
Viet Nam,2009,43813576,43278674,61504167,26061240,87092250
Viet Nam,2010,44221289,43746366,61561816,26910696,87967655
Viet Nam,2011,44648193,44223191,61639703,27796941,88871384
Viet Nam,2012,45092770,44709156,61731739,28720142,89801926
Viet Nam,2013,45550533,45202060,61825502,29672223,90752593
Viet Nam,2014,46014709,45699141,61898224,30646691,91713850
Viet Nam,2015,46479616,46197466,61936198,31635369,92677082
Viet Nam,2016,46944163,46696272,61933285,32635787,93640435
Viet Nam,2017,47407628,47193015,61898302,33642498,94600643
Viet Nam,2018,47865095,47680864,61832185,34658961,95545959
Yemen,2000,8626157,8782914,13179604,4695121,17409071
Yemen,2001,8882752,9035617,13463940,4926195,17918369
Yemen,2002,9145682,9298002,13751457,5167722,18443684
Yemen,2003,9415229,9569772,14042142,5419944,18985001
Yemen,2004,9691050,9849046,14334252,5682816,19540096
Yemen,2005,9972934,10134482,14627103,5955824,20107416
Yemen,2006,10261091,10426557,14920358,6240176,20687648
Yemen,2007,10556029,10726485,15215074,6536531,21282514
Yemen,2008,10857975,11034174,15511106,6845285,21892149
Yemen,2009,11167099,11349365,15808153,7166776,22516464
Yemen,2010,11483269,11671585,16105593,7501186,23154854
Yemen,2011,11806655,12000931,16403293,7848913,23807586
Yemen,2012,12136525,12336651,16700108,8209861,24473176
Yemen,2013,12470750,12676362,16993264,8583058,25147112
Yemen,2014,12806509,13016979,17279298,8967029,25823488
Yemen,2015,13141685,13356196,17555636,9360571,26497881
Yemen,2016,13475302,13692908,17821118,9763095,27168210
Yemen,2017,13807512,14027299,18075808,10174612,27834811
Yemen,2018,14138669,14360014,18320024,10595260,28498683
Zambia,2000,5251908,5164034,6866093,3665128,10415942
Zambia,2001,5394084,5298113,7035435,3788690,10692197
Zambia,2002,5538432,5433272,7175419,3944990,10971704
Zambia,2003,5685882,5570858,7315663,4106321,11256740
Zambia,2004,5837791,5712850,7457838,4273908,11550641
Zambia,2005,5995319,5860925,7603597,4448559,11856244
Zambia,2006,6158454,6015064,7752680,4630766,12173518
Zambia,2007,6327444,6175514,7905217,4820757,12502958
Zambia,2008,6503983,6344548,8062650,5019867,12848531
Zambia,2009,6690201,6524941,8227066,5229350,13215142
Zambia,2010,6887474,6718512,8399366,5450667,13605986
Zambia,2011,7096729,6926470,8580164,5684592,14023199
Zambia,2012,7317296,7147852,8767868,5932069,14465148
Zambia,2013,7547003,7379548,8960891,6192319,14926551
Zambia,2014,7782731,7617062,9156664,6464310,15399793
Zambia,2015,8022199,7857171,9353351,6747236,15879370
Zambia,2016,8264686,8098763,9550308,7041082,16363449
Zambia,2017,8510848,8342760,9747709,7346421,16853608
Zambia,2018,8761437,8590277,9945501,7663677,17351714
Zimbabwe,2000,6067179,5814303,8096262,4125988,11881482
Zimbabwe,2001,6111887,5812019,8140630,4225535,11923906
Zimbabwe,2002,6154635,5799658,8177189,4323336,11954293
Zimbabwe,2003,6197522,5784697,8277834,4356063,11982219
Zimbabwe,2004,6242964,5776947,8395569,4381942,12019911
Zimbabwe,2005,6293011,5783686,8526166,4413866,12076697
Zimbabwe,2006,6347986,5807510,8671680,4452587,12155496
Zimbabwe,2007,6408522,5847398,8831989,4497920,12255920
Zimbabwe,2008,6477094,5902459,9008248,4550221,12379553
Zimbabwe,2009,6556601,5970363,9200909,4609690,12526964
Zimbabwe,2010,6648704,6049024,9410211,4676106,12697728
Zimbabwe,2011,6755208,6139115,9636932,4749717,12894323
Zimbabwe,2012,6874616,6240533,9880721,4830105,13115149
Zimbabwe,2013,7001157,6349221,10138667,4915839,13350378
Zimbabwe,2014,7126795,6459915,10402274,5009401,13586710
Zimbabwe,2015,7245864,6568778,10667966,5109485,13814642
Zimbabwe,2016,7356132,6674206,10934468,5215894,14030338
Zimbabwe,2017,7459545,6777054,11201138,5328766,14236599
Zimbabwe,2018,7559693,6879119,11465748,5447513,14438812
